nirakz	akz
samakz	akz
aByaGAy	aGAy
aByaGAya	aGAy
paryaNKay	aNKay
paryaNK	aNKay
anvac	ac
anvaYc	ac
apAc	ac
apAYc	ac
avAc	ac
avAYc	ac
Ac	ac
AYc	ac
udac	ac
udaYc	ac
vyudac	ac
vyudaYc	ac
samudac	ac
samudaYc	ac
upAc	ac
upAYc	ac
nyac	ac
nyaYc	ac
paryac	ac
paryaYc	ac
pratyac	ac
pratyaYc	ac
vyac	ac
vyaYc	ac
samac	ac
samaYc	ac
atyaj	aj
apAj	aj
aByaj	aj
avAj	aj
Aj	aj
aByAj	aj
udaj	aj
upAj	aj
niraj	aj
prAj	aj
vyaj	aj
samaj	aj
anvaYj	aYj
antaraYj	aYj
aByaYj	aYj
AYj	aYj
samAYj	aYj
udaYj	aYj
upAYj	aYj
nyaYj	aYj
pratyaYj	aYj
vyaYj	aYj
anuvyaYj	aYj
aBivyaYj	aYj
samaYj	aYj
paryaw	aw
aByat	at
avAt	at
samat	at
apyad	ad
avAd	ad
Ad	ad
prAd	ad
pratyad	ad
vyad	ad
samad	ad
apAn	an
aByapAn	an
avAn	an
vyavAn	an
udAn	an
udan	an
aByudan	an
parAn	an
prAn	an
anuprAn	an
aBiprAn	an
vyan	an
aBivyan	an
saman	an
anusaman	an
aByam	am
paryam	am
vyam	am
samam	am
anvar	ar
anvf	ar
apAr	ar
aByar	ar
aByf	ar
Ar	ar
udar	ar
udf	ar
upAr	ar
nyar	ar
nyf	ar
nirar	ar
nisf	ar
prAr	ar
pratyar	ar
pratyf	ar
vyar	ar
vyf	ar
samar	ar
samf	ar
aBisamar	ar
aBisamf	ar
anvarc	arc
aByarc	arc
samaByarc	arc
prArc	arc
aBiprArc	arc
pratyarc	arc
samarc	arc
apArC	arC
aByarC	arC
aByfC	arC
avArC	arC
ArC	arC
udarC	arC
udfC	arC
upArC	arC
nyarC	arC
nyfC	arC
nirarC	arC
nisfC	arC
saMnirarC	arC
saMnisfC	arC
prArC	arC
vyarC	arC
vyfC	arC
samarC	arC
samfC	arC
atyarj	arj
apyatyarj	arj
aByatyarj	arj
anvarj	arj
apyarj	arj
avArj	arj
anvavArj	arj
samavArj	arj
samArj	arj
udarj	arj
upArj	arj
samupArj	arj
prArj	arj
aByarTay	arTay
aByarT	arTay
prArTay	arTay
prArT	arTay
aBiprArTay	arTay
aBiprArT	arTay
saMprArTay	arTay
saMprArT	arTay
pratyarTay	arTay
pratyarT	arTay
samarTay	arTay
samarT	arTay
atyard	ard
aByard	ard
udard	ard
nyard	ard
nirard	ard
prArd	ard
pratyard	ard
vyard	ard
samard	ard
aDyarD	arD
aDyfD	arD
anvarD	arD
anvfD	arD
ArD	arD
upArD	arD
vyarD	arD
vyfD	arD
samarD	arD
samfD	arD
anvarz	arz
anvfz	arz
aByarz	arz
aByfz	arz
paryarz	arz
paryfz	arz
prArz	arz
vyarz	arz
vyfz	arz
samarz	arz
samfz	arz
aDyarz	arz
aDyfz	arz
udarz	arz
udfz	arz
upArz	arz
nyarz	arz
nyfz	arz
atyarh	arh
aByarh	arh
prArh	arh
samarh	arh
anvav	av
aByav	av
udav	av
upAv	av
prAv	av
saMprAv	av
samav	av
anvaS	aS
aByaS	aS
AS	aS
udaS	aS
upAS	aS
samupAS	aS
paryaS	aS
prAS	aS
pratyaS	aS
vyaS	aS
anuvyaS	aS
samaS	aS
anusamaS	aS
upasamaS	aS
atyaS	aS
niraS	aS
aBiprAS	aS
vyaSAy	aSAy
vyaSAya	aSAy
atyas	as
vyatyas	as
anvas	as
vyatyanvas	as
apAs	as
apyas	as
aByas	as
upAs	as
nyas	as
paryas	as
prAs	as
pratyas	as
vyas	as
samas	as
aDyas	as
udapAs	as
samaByas	as
avAs	as
anvavAs	as
aByavAs	as
As	as
udas	as
anUdas	as
paryudas	as
vyudas	as
aBivyudas	as
udvyudas	as
vyupAs	as
aBinyas	as
upanyas	as
parinyas	as
pratinyas	as
vinyas	as
saMnyas	as
upasaMnyas	as
niras	as
aBiniras	as
parAs	as
viparyas	as
saMparyas	as
anuprAs	as
aBiprAs	as
pratiprAs	as
pravyas	as
anusamas	as
upasamas	as
aDyah	ah
anvah	ah
aByah	ah
nirah	ah
parAh	ah
paryah	ah
prAh	ah
pratyah	ah
vyah	ah
anvAp	Ap
aByAp	Ap
avAp	Ap
pratyavAp	Ap
samavAp	Ap
Ap	Ap
udAp	Ap
upAp	Ap
samupAp	Ap
paryAp	Ap
saMparyAp	Ap
prAp	Ap
anuprAp	Ap
samanuprAp	Ap
aBiprAp	Ap
upaprAp	Ap
pariprAp	Ap
saMpariprAp	Ap
saMprAp	Ap
anusaMprAp	Ap
aBisaMprAp	Ap
upasaMprAp	Ap
pratyAp	Ap
vyAp	Ap
aBivyAp	Ap
samAp	Ap
anusamAp	Ap
parisamAp	Ap
aDyAs	As
samaDyAs	As
anvAs	As
antarAs	As
udAs	As
upAs	As
paryupAs	As
samupAs	As
paryAs	As
pratyAs	As
samAs	As
pratisamAs	As
acCe	i
atI	i
anvatI	i
apAtI	i
aByatI	i
upAtI	i
antarupAtI	i
prAtI	i
vyatI	i
samatI	i
aDI	i
upADI	i
prADI	i
pratyaDI	i
samaDI	i
anvi	i
samanvi	i
antari	i
ape	i
vyape	i
apI	i
aBI	i
udaBI	i
samaBI	i
ave	i
anvave	i
aByave	i
samaByave	i
Ave	i
upAve	i
paryave	i
pratyave	i
aBipratyave	i
vyave	i
anuvyave	i
samave	i
e	i
acCe	i
atye	i
anve	i
aBye	i
samaBye	i
ave	i
ude	i
anUde	i
aByude	i
upode	i
upe	i
aByupe	i
nye	i
nire	i
pare	i
parye	i
anuparye	i
aBiparye	i
pratye	i
pre	i
same	i
aBisame	i
upasame	i
parisame	i
udi	i
anUdi	i
apodi	i
aByudi	i
upodi	i
prodi	i
pratyudi	i
samudi	i
upe	i
aDyupe	i
aByupe	i
samaByupe	i
samope	i
pratyupe	i
vyupe	i
samupe	i
duri	i
nI	i
aBinI	i
upanI	i
niri	i
anupare	i
apapare	i
aBipare	i
upapare	i
pratipare	i
vipare	i
saMpare	i
parI	i
anuparI	i
aBiparI	i
pratiparI	i
viparI	i
prativiparI	i
saMparI	i
pale	i
prapale	i
vipale	i
saMpale	i
palI	i
upapalI	i
vipalI	i
pre	i
anupre	i
apapre	i
aBipre	i
upapre	i
paripre	i
vipre	i
saMpre	i
pratI	i
ApratI	i
saMpratI	i
ple	i
upaple	i
vI	i
anuvI	i
aBivI	i
parivI	i
sami	i
atisami	i
anusami	i
aBisami	i
upasami	i
udiNg	iNg
vINg	iNg
samiNg	iNg
anviD	iD
anvinD	iD
aBID	iD
aBInD	iD
eD	iD
enD	iD
parID	iD
parInD	iD
preD	iD
prenD	iD
saMpreD	iD
saMprenD	iD
pratID	iD
pratInD	iD
samiD	iD
saminD	iD
aBisamiD	iD
aBisaminD	iD
upasamiD	iD
upasaminD	iD
avenv	inv
env	inv
upenv	inv
prenv	inv
pratInv	inv
vInv	inv
saminv	inv
aBIyakz	iyakz
preyakz	iyakz
prerajy	irajy
prerajya	irajy
aBIrasya	irasya
avel	il
prADIz	iz
anviz	iz
samanviz	iz
apIz	iz
parIz	iz
prez	iz
anuprez	iz
aBiprez	iz
upaprez	iz
niprez	iz
pariprez	iz
saMprez	iz
samiz	iz
aDIz	iz
paryanviz	iz
antariz	iz
aBIz	iz
pratIz	iz
vIz	iz
samizaRy	izaRy
samizaRya	izaRy
aDIkz	Ikz
anvIkz	Ikz
apekz	Ikz
vyapekz	Ikz
aBIkz	Ikz
avekz	Ikz
anvavekz	Ikz
aByavekz	Ikz
upAvekz	Ikz
nyavekz	Ikz
niravekz	Ikz
paryavekz	Ikz
pratyavekz	Ikz
samavekz	Ikz
ekz	Ikz
udIkz	Ikz
aByudIkz	Ikz
pratyudIkz	Ikz
samudIkz	Ikz
upekz	Ikz
aByupekz	Ikz
samupekz	Ikz
nirIkz	Ikz
saMnirIkz	Ikz
parekz	Ikz
parIkz	Ikz
upaparIkz	Ikz
prekz	Ikz
anuprekz	Ikz
aBiprekz	Ikz
samaBiprekz	Ikz
Aprekz	Ikz
utprekz	Ikz
upaprekz	Ikz
viprekz	Ikz
saMprekz	Ikz
aBisaMprekz	Ikz
pratIkz	Ikz
saMpratIkz	Ikz
vIkz	Ikz
anuvIkz	Ikz
samanuvIkz	Ikz
aBivIkz	Ikz
samaBivIkz	Ikz
udvIkz	Ikz
samudvIkz	Ikz
upavIkz	Ikz
prativIkz	Ikz
saMvIkz	Ikz
aBisaMvIkz	Ikz
samIkz	Ikz
anusamIkz	Ikz
aBisamIkz	Ikz
prasamIkz	Ikz
pratisamIkz	Ikz
sameNK	INK
parINK	INK
preNK	INK
apej	Ij
samIj	Ij
preq	Iq
aBIr	Ir
vyaver	Ir
er	Ir
nyer	Ir
samer	Ir
udIr	Ir
aByudIr	Ir
pratyudIr	Ir
samudIr	Ir
nIr	Ir
prer	Ir
aBiprer	Ir
saMprer	Ir
pratIr	Ir
vIr	Ir
samIr	Ir
aBisamIr	Ir
parIS	IS
atIz	Iz
apez	Iz
ez	Iz
upez	Iz
pratyez	Iz
udIz	Iz
samudIz	Iz
upez	Iz
pratIz	Iz
vIz	Iz
samIz	Iz
pratIh	Ih
samIh	Ih
o	u
vyu	u
anUkz	ukz
aByukz	ukz
udukz	ukz
upokz	ukz
nirukz	ukz
paryukz	ukz
anuparyukz	ukz
aBiparyukz	ukz
prokz	ukz
saMprokz	ukz
vyukz	ukz
aBivyukz	ukz
samukz	ukz
aByuc	uc
nyuc	uc
samuc	uc
projJ	ujJ
samujJ	ujJ
proYC	uYC
protkaRW	utkaRW
protkaRWa	utkaRW
samutkaRW	utkaRW
samutkaRWa	utkaRW
anUd	ud
avod	ud
upod	ud
nyud	ud
vyud	ud
udubj	ubj
nyubj	ubj
aBinyubj	ubj
nirubj	ubj
vyubj	ubj
samubj	ubj
aBisamubj	ubj
apoB	uB
nyuB	uB
proB	uB
samuB	uB
prollAGay	ullAGay
prollAGaya	ullAGay
aByuz	uz
uduz	uz
upoz	uz
samupoz	uz
nyuz	uz
pratyuz	uz
samuz	uz
aporRu	UrRu
pratyaporRu	UrRu
aByUrRu	UrRu
orRu	UrRu
paryUrRu	UrRu
prorRu	UrRu
saMprorRu	UrRu
vyUrRu	UrRu
atyUh	Uh
vyatyUh	Uh
aDyUh	Uh
apoh	Uh
avApoh	Uh
vyapoh	Uh
samapoh	Uh
aByUh	Uh
avoh	Uh
udUh	Uh
apodUh	Uh
aByudUh	Uh
pratyudUh	Uh
vyudUh	Uh
upoh	Uh
samupoh	Uh
nyUh	Uh
nirUh	Uh
paryUh	Uh
viparyUh	Uh
proh	Uh
pratyUh	Uh
vyUh	Uh
anuvyUh	Uh
nirvyUh	Uh
prativyUh	Uh
samUh	Uh
aBisamUh	Uh
upasamUh	Uh
parisamUh	Uh
anUh	Uh
apyUh	Uh
vyoh	Uh
udej	ej
prej	ej
samej	ej
upeqakIy	eqakIy
upeqakIya	eqakIy
aDyeD	eD
upeD	eD
sameD	eD
atyez	ez
upez	ez
parAoK	oK
Akac	kac
utkac	kac
vikac	kac
Akaww	kaww
nikaR	kaR
vikatT	katT
anukaTay	kaTay
anukaT	kaTay
nikaTay	kaTay
nikaT	kaTay
parikaTay	kaTay
parikaT	kaTay
prakaTay	kaTay
prakaT	kaTay
vikaTay	kaTay
vikaT	kaTay
saMkaTay	kaTay
saMkaT	kaTay
Akan	kan
anukam	kam
aBikam	kam
nikam	kam
prakam	kam
anukamp	kamp
samanukamp	kamp
aBikamp	kamp
Akamp	kamp
utkamp	kamp
parikamp	kamp
saMparikamp	kamp
prakamp	kamp
anuprakamp	kamp
aBiprakamp	kamp
samprakamp	kamp
pratikamp	kamp
vikamp	kamp
saMkamp	kamp
atikar	kar
atikf	kar
vyatikar	kar
vyatikf	kar
aDikar	kar
aDikf	kar
anukar	kar
anukf	kar
apakar	kar
apakf	kar
pratyapakar	kar
pratyapakf	kar
apikar	kar
apikf	kar
aBikar	kar
aBikf	kar
araMkar	kar
araMkf	kar
alaMkar	kar
alaMkf	kar
avakar	kar
avakf	kar
anvavakar	kar
anvavakf	kar
Akar	kar
Akf	kar
atyAkar	kar
atyAkf	kar
anvAkar	kar
anvAkf	kar
apAkar	kar
apAkf	kar
vyapAkar	kar
vyapAkf	kar
avAkar	kar
avAkf	kar
udAkar	kar
udAkf	kar
upAkar	kar
upAkf	kar
aByupAkar	kar
aByupAkf	kar
pratyupAkar	kar
pratyupAkf	kar
samupAkar	kar
samupAkf	kar
nyAkar	kar
nyAkf	kar
nirAkar	kar
nirAkf	kar
paryAkar	kar
paryAkf	kar
prAkar	kar
prAkf	kar
samAkar	kar
samAkf	kar
upasamAkar	kar
upasamAkf	kar
izkar	kar
izkf	kar
utkar	kar
utkf	kar
upakar	kar
upakf	kar
pratyupakar	kar
pratyupakf	kar
nikar	kar
nikf	kar
pranikar	kar
pranikf	kar
vinikar	kar
vinikf	kar
nizkar	kar
nizkf	kar
aBinizkar	kar
aBinizkf	kar
upanizkar	kar
upanizkf	kar
vinizkar	kar
vinizkf	kar
parAkar	kar
parAkf	kar
parikar	kar
parikf	kar
prakar	kar
prakf	kar
viprakar	kar
viprakf	kar
samprakar	kar
samprakf	kar
pratikar	kar
pratikf	kar
vikar	kar
vikf	kar
anuvikar	kar
anuvikf	kar
saMkar	kar
saMkf	kar
aBisaMkar	kar
aBisaMkf	kar
upasaMkar	kar
upasaMkf	kar
pratisaMkar	kar
pratisaMkf	kar
aByavakar	kar
aByavakf	kar
paryavakar	kar
paryavakf	kar
vyavakar	kar
vyavakf	kar
samavakar	kar
samavakf	kar
ayAkar	kar
ayAkf	kar
samutkar	kar
samutkf	kar
saMnikar	kar
saMnikf	kar
anuparikar	kar
anuparikf	kar
samprakar	kar
samprakf	kar
pravikar	kar
pravikf	kar
samaDikart	kart
samaDikft	kart
anukart	kart
anukft	kart
apakart	kart
apakft	kart
apikart	kart
apikft	kart
avakart	kart
avakft	kart
utkart	kart
utkft	kart
samutkart	kart
samutkft	kart
upakart	kart
upakft	kart
nikart	kart
nikft	kart
vinikart	kart
vinikft	kart
nizkart	kart
nizkft	kart
parikart	kart
parikft	kart
prakart	kart
prakft	kart
vikart	kart
vikft	kart
aDivikart	kart
aDivikft	kart
saMkart	kart
saMkft	kart
anukarS	karS
anukfS	karS
avakarS	karS
avakfS	karS
parikarS	karS
parikfS	karS
prakarS	karS
prakfS	karS
vikarS	karS
vikfS	karS
atikarz	karz
atikfz	karz
anukarz	karz
anukfz	karz
apakarz	karz
apakfz	karz
vyapakarz	karz
vyapakfz	karz
aBikarz	karz
aBikfz	karz
avakarz	karz
avakfz	karz
aByavakarz	karz
aByavakfz	karz
vyavakarz	karz
vyavakfz	karz
Akarz	karz
Akfz	karz
apAkarz	karz
apAkfz	karz
vyapAkarz	karz
vyapAkfz	karz
aByAkarz	karz
aByAkfz	karz
paryAkarz	karz
paryAkfz	karz
pratyAkarz	karz
pratyAkfz	karz
vyAkarz	karz
vyAkfz	karz
samAkarz	karz
samAkfz	karz
utkarz	karz
utkfz	karz
apotkarz	karz
apotkfz	karz
pratyutkarz	karz
pratyutkfz	karz
samutkarz	karz
samutkfz	karz
upakarz	karz
upakfz	karz
samupakarz	karz
samupakfz	karz
nikarz	karz
nikfz	karz
saMnikarz	karz
saMnikfz	karz
nizkarz	karz
nizkfz	karz
parAkarz	karz
parAkfz	karz
parikarz	karz
parikfz	karz
prakarz	karz
prakfz	karz
viprakarz	karz
viprakfz	karz
samprakarz	karz
samprakfz	karz
pratikarz	karz
pratikfz	karz
vikarz	karz
vikfz	karz
saMkarz	karz
saMkfz	karz
avakal	kal
vyavakal	kal
Akal	kal
pratyAkal	kal
utkal	kal
parikal	kal
saMkal	kal
pratyAsaMkal	kal
utsaMkal	kal
upakal	kal
nizkal	kal
prakal	kal
anusaMkal	kal
anukalp	kalp
anukxp	kalp
samanukalp	kalp
samanukxp	kalp
aBikalp	kalp
aBikxp	kalp
avakalp	kalp
avakxp	kalp
Akalp	kalp
Akxp	kalp
utkalp	kalp
utkxp	kalp
upakalp	kalp
upakxp	kalp
samupakalp	kalp
samupakxp	kalp
parikalp	kalp
parikxp	kalp
prakalp	kalp
prakxp	kalp
samprakalp	kalp
samprakxp	kalp
pratikalp	kalp
pratikxp	kalp
vikalp	kalp
vikxp	kalp
saMkalp	kalp
saMkxp	kalp
upasaMkalp	kalp
upasaMkxp	kalp
apakaz	kaz
Akaz	kaz
utkaz	kaz
nikaz	kaz
nizkaz	kaz
utkas	kas
nizkas	kas
prakas	kas
vikas	kas
anuvikas	kas
pravikas	kas
saMkas	kas
anukA	kA
AkA	kA
saMkA	kA
anukANkz	kANkz
aBikANkz	kANkz
avakANkz	kANkz
AkANkz	kANkz
aByAkANkz	kANkz
pratyAkANkz	kANkz
samAkANkz	kANkz
parikANkz	kANkz
prakANkz	kANkz
pratikANkz	kANkz
vikANkz	kANkz
atikAS	kAS
anukAS	kAS
aBikAS	kAS
avakAS	kAS
AkAS	kAS
utkAS	kAS
nikAS	kAS
saMnikAS	kAS
nizkAS	kAS
prakAS	kAS
aBiprakAS	kAS
samprakAS	kAS
pratikAS	kAS
vikAS	kAS
anuvikAS	kAS
pravikAS	kAS
saMkAS	kAS
pratisaMkAS	kAS
utkAs	kAs
anukIrtay	kIrtay
anukIrt	kIrtay
samanukIrtay	kIrtay
samanukIrt	kIrtay
samaBikIrtay	kIrtay
samaBikIrt	kIrtay
utkIrtay	kIrtay
utkIrt	kIrtay
parikIrtay	kIrtay
parikIrt	kIrtay
saMparikIrtay	kIrtay
saMparikIrt	kIrtay
prakIrtay	kIrtay
prakIrt	kIrtay
samprakIrtay	kIrtay
samprakIrt	kIrtay
saMkIrtay	kIrtay
saMkIrt	kIrtay
anukuc	kuc
avakuc	kuc
Akuc	kuc
samAkuc	kuc
utkuc	kuc
saMnikuc	kuc
vikuc	kuc
saMkuc	kuc
prakuw	kuw
utkuw	kuw
vikuw	kuw
saMkuw	kuw
vikuww	kuww
vikuRW	kuRW
avakuRW	kuRW
aBikutsay	kutsay
aBikuts	kutsay
nikuT	kuT
prakuT	kuT
pranikunT	kunT
atikup	kup
parikup	kup
prakup	kup
pratikup	kup
saMkup	kup
anukuz	kuz
aBikuz	kuz
avakuz	kuz
nizkuz	kuz
aBinizkuz	kuz
vikuz	kuz
saMkuz	kuz
AkU	kU
anukUj	kUj
aBikUj	kUj
avakUj	kUj
AkUj	kUj
utkUj	kUj
protkUj	kUj
upakUj	kUj
nikUj	kUj
nizkUj	kUj
parikUj	kUj
prakUj	kUj
pratikUj	kUj
vikUj	kUj
saMkUj	kUj
upakUq	kUq
nikUR	kUR
vikUR	kUR
atikUrd	kUrd
utkUrd	kUrd
prakUrd	kUrd
avakUl	kUl
anukfpAy	kfpAy
anukfpAya	kfpAy
saMketay	ketay
saMketaya	ketay
aBiknUy	knUy
avakrakz	krakz
utkraT	kraT
anukrand	krand
aBikrand	krand
avakrand	krand
aByavakrand	krand
Akrand	krand
samAkrand	krand
nikrand	krand
parikrand	krand
prakrand	krand
vikrand	krand
saMkrand	krand
anukrap	krap
atikram	kram
atyatikram	kram
aByatikram	kram
samaByatikram	kram
vyatikram	kram
samatikram	kram
aDikram	kram
anukram	kram
samanukram	kram
apakram	kram
anvapakram	kram
aByapakram	kram
vyapakram	kram
aBikram	kram
samaBikram	kram
avakram	kram
anvavakram	kram
Akram	kram
atyAkram	kram
aDyAkram	kram
anvAkram	kram
apAkram	kram
aByAkram	kram
upAkram	kram
samupAkram	kram
nirAkram	kram
pratyAkram	kram
samAkram	kram
utkram	kram
atyutkram	kram
anUtkram	kram
aByutkram	kram
upotkram	kram
pratyutkram	kram
vyutkram	kram
samutkram	kram
upakram	kram
pratyupakram	kram
samupakram	kram
nikram	kram
anunikram	kram
aBinikram	kram
nizkram	kram
anunizkram	kram
aBinizkram	kram
upanizkram	kram
vinizkram	kram
parAkram	kram
parikram	kram
anuparikram	kram
viparikram	kram
saMparikram	kram
prakram	kram
aBiprakram	kram
samprakram	kram
pratikram	kram
anupratikram	kram
vikram	kram
aDivikram	kram
anuvikram	kram
nirvikram	kram
saMkram	kram
anusaMkram	kram
aBisaMkram	kram
upasaMkram	kram
pratisaMkram	kram
anukrI	krI
apakrI	krI
aBikrI	krI
avakrI	krI
AkrI	krI
upakrI	krI
nizkrI	krI
parikrI	krI
prakrI	krI
vikrI	krI
saMkrI	krI
aDikrIq	krIq
anukrIq	krIq
avakrIq	krIq
AkrIq	krIq
samAkrIq	krIq
upakrIq	krIq
nikrIq	krIq
parikrIq	krIq
prakrIq	krIq
vikrIq	krIq
saMkrIq	krIq
parisaMkrIq	krIq
aBikruD	kruD
samaBikruD	kruD
parikruD	kruD
pratikruD	kruD
saMkruD	kruD
aBisaMkruD	kruD
atikruS	kruS
anukruS	kruS
apakruS	kruS
aBikruS	kruS
avakruS	kruS
AkruS	kruS
aByAkruS	kruS
pratyAkruS	kruS
vyAkruS	kruS
samAkruS	kruS
utkruS	kruS
aByutkruS	kruS
protkruS	kruS
samutkruS	kruS
upakruS	kruS
parikruS	kruS
prakruS	kruS
vikruS	kruS
saMkruS	kruS
aBisaMkruS	kruS
pariklam	klam
viklam	klam
viklav	klav
avaklid	klid
Aklid	klid
samAklid	klid
utklid	klid
upaklid	klid
pariklid	klid
praklid	klid
viklid	klid
saMklid	klid
utkliS	kliS
samutkliS	kliS
parikliS	kliS
prakliS	kliS
samprakliS	kliS
vikliS	kliS
saMkliS	kliS
upakvaR	kvaR
nikvaR	kvaR
parikvaR	kvaR
prakvaR	kvaR
utkvaT	kvaT
nikvaT	kvaT
nizkvaT	kvaT
parikvaT	kvaT
aBikzad	kzad
upkzan	kzan
parikzan	kzan
vikzan	kzan
aBivikzan	kzan
parivikzan	kzan
saMkzap	kzap
aBikzam	kzam
saMkzam	kzam
atikzar	kzar
aByatikzar	kzar
anukzar	kzar
aBikzar	kzar
avakzar	kzar
Akzar	kzar
upakzar	kzar
parikzar	kzar
prakzar	kzar
aBiprakzar	kzar
plakzar	kzar
vikzar	kzar
saMkzar	kzar
avakzal	kzal
parikzal	kzal
prakzal	kzal
aBiprakzal	kzal
vikzal	kzal
apakzA	kzA
apakzE	kzA
apikzA	kzA
apikzE	kzA
avakzA	kzA
avakzE	kzA
parikzA	kzA
parikzE	kzA
prakzA	kzA
prakzE	kzA
samprakzA	kzA
samprakzE	kzA
vikzA	kzA
vikzE	kzA
saMkzA	kzA
saMkzE	kzA
aDikzi	kzi
Akzi	kzi
upakzi	kzi
parikzi	kzi
pratikzi	kzi
saMkzi	kzi
nukzi	kzi
apakzi	kzi
avakzi	kzi
nizkzi	kzi
prakzi	kzi
vikzi	kzi
atikzip	kzip
aDikzip	kzip
apakzip	kzip
aBikzip	kzip
avakzip	kzip
samavakzip	kzip
Akzip	kzip
paryAkzip	kzip
vyAkzip	kzip
samAkzip	kzip
utkzip	kzip
protkzip	kzip
samutkzip	kzip
upakzip	kzip
nikzip	kzip
upanikzip	kzip
pratinikzip	kzip
vinikzip	kzip
saMnikzip	kzip
nizkzip	kzip
parAkzip	kzip
parikzip	kzip
prakzip	kzip
samprakzip	kzip
pratikzip	kzip
vikzip	kzip
saMkzip	kzip
aBisaMkzip	kzip
upasaMkzip	kzip
parisaMkzip	kzip
prakzIb	kzIb
avakzu	kzu
parikzu	kzu
avakzud	kzud
prakzud	kzud
vikzud	kzud
saMkzud	kzud
vikzuD	kzuD
nikzuB	kzuB
prakzuB	kzuB
samprakzuB	kzuB
vikzuB	kzuB
parivikzuB	kzuB
saMkzuB	kzuB
avakzRu	kzRu
AkzRu	kzRu
prakzRu	kzRu
saMkzRu	kzRu
vikzmAy	kzmAy
Akzviq	kzviq
utkzvid	kzvid
nikzvid	kzvid
prakzvid	kzvid
utKac	Kac
pariKac	Kac
avaKaRqay	KaRqay
avaKaRq	KaRqay
AKaRqay	KaRqay
AKaRq	KaRqay
utKaRqay	KaRqay
utKaRq	KaRqay
pariKaRqay	KaRqay
pariKaRq	KaRqay
viKaRqay	KaRqay
viKaRq	KaRqay
praniKad	Kad
aBiKan	Kan
AKan	Kan
utKan	Kan
protKan	Kan
samutKan	Kan
niKan	Kan
nisKan	Kan
pariKan	Kan
praKan	Kan
viKan	Kan
protKA	KA
protKE	KA
avaKAd	KAd
AKAd	KAd
praniKAd	KAd
praKAd	KAd
viKAd	KAd
saMKAd	KAd
AKid	Kid
utKid	Kid
niKid	Kid
nisKid	Kid
pariKid	Kid
praKid	Kid
viKid	Kid
saMKid	Kid
praKud	Kud
atiKyA	KyA
anuKyA	KyA
antarKyA	KyA
aBiKyA	KyA
avaKyA	KyA
AKyA	KyA
anvAKyA	KyA
aByAKyA	KyA
udAKyA	KyA
upAKyA	KyA
pratyAKyA	KyA
vyAKyA	KyA
anuvyAKyA	KyA
upavyAKyA	KyA
samAKyA	KyA
upaKyA	KyA
parAKyA	KyA
pariKyA	KyA
saMpariKyA	KyA
praKyA	KyA
pratiKyA	KyA
viKyA	KyA
aBiviKyA	KyA
saMKyA	KyA
anusaMKyA	KyA
aBisaMKyA	KyA
upasaMKyA	KyA
parisaMKyA	KyA
prasaMKyA	KyA
pratisaMKyA	KyA
aDigaRay	gaRay
aDigaR	gaRay
anugaRay	gaRay
anugaR	gaRay
avagaRay	gaRay
avagaR	gaRay
AgaRay	gaRay
AgaR	gaRay
parigaRay	gaRay
parigaR	gaRay
pragaRay	gaRay
pragaR	gaRay
vigaRay	gaRay
vigaR	gaRay
samgaRay	gaRay
samgaR	gaRay
anugad	gad
praRyAgad	gad
nigad	gad
aBinigad	gad
pariRigad	gad
praRigad	gad
pratinigad	gad
vinigad	gad
parigad	gad
pragad	gad
pratigad	gad
vigad	gad
AgaD	gaD
parigaD	gaD
acCagam	gam
atigam	gam
upAtigam	gam
vyatigam	gam
aDigam	gam
samaDigam	gam
anugam	gam
samanugam	gam
antargam	gam
apagam	gam
vyapagam	gam
apigam	gam
aBigam	gam
samaBigam	gam
aramgam	gam
avagam	gam
aDyavagam	gam
pratyavagam	gam
samavagam	gam
Agam	gam
aDyAgam	gam
anvAgam	gam
samanvAgam	gam
aByAgam	gam
samaByAgam	gam
avAgam	gam
samudAgam	gam
upAgam	gam
aByupAgam	gam
paryupAgam	gam
samupAgam	gam
nyAgam	gam
pratinyAgam	gam
paryAgam	gam
pratyAgam	gam
sampratyAgam	gam
samAgam	gam
aBisamAgam	gam
udgam	gam
apodgam	gam
aByudgam	gam
prodgam	gam
pratyudgam	gam
samudgam	gam
upagam	gam
aByupagam	gam
samupagam	gam
nigam	gam
upanigam	gam
saMnigam	gam
vinigam	gam
nirgam	gam
aBinirgam	gam
vinirgam	gam
saMnirgam	gam
parAgam	gam
anuparAgam	gam
parigam	gam
pragam	gam
vipragam	gam
pratigam	gam
vigam	gam
pravigam	gam
samgam	gam
anusamgam	gam
aBisamgam	gam
upasamgam	gam
anugar	gar
anugF	gar
apagar	gar
apagF	gar
apigar	gar
apigF	gar
aBigar	gar
aBigF	gar
Agar	gar
AgF	gar
pratyAgar	gar
pratyAgF	gar
upagar	gar
upagF	gar
pragar	gar
pragF	gar
sampragar	gar
sampragF	gar
pratigar	gar
pratigF	gar
aBipratigar	gar
aBipratigF	gar
vigar	gar
vigF	gar
samgar	gar
samgF	gar
aBisamgar	gar
aBisamgF	gar
avagar	gar
avagF	gar
udgar	gar
udgF	gar
pratyudgar	gar
pratyudgF	gar
samudgar	gar
samudgF	gar
nigar	gar
nigF	gar
nirgar	gar
nirgF	gar
atigarj	garj
anugarj	garj
aBigarj	garj
samaBigarj	garj
udgarj	garj
parigarj	garj
pragarj	garj
sampragarj	garj
pratigarj	garj
vigarj	garj
samgarj	garj
anugarD	garD
anugfD	garD
aBigarD	garD
aBigfD	garD
pragarD	garD
pragfD	garD
pratigarD	garD
pratigfD	garD
avagarh	garh
nigarh	garh
parigarh	garh
vigarh	garh
avagal	gal
Agal	gal
paryAgal	gal
samAgal	gal
udgal	gal
nigal	gal
nirgal	gal
parigal	gal
pragal	gal
vigal	gal
pravigal	gal
parigavez	gavez
acCagA	gA
atigA	gA
vyatigA	gA
aDigA	gA
anugA	gA
samanugA	gA
antargA	gA
apagA	gA
apigA	gA
aBigA	gA
avagA	gA
anvavagA	gA
samaByavagA	gA
anuvyavagA	gA
AgA	gA
anvAgA	gA
aByAgA	gA
samaByAgA	gA
udAgA	gA
upAgA	gA
paryAgA	gA
anuparyAgA	gA
udgA	gA
aByudgA	gA
pratyudgA	gA
upagA	gA
nigA	gA
nirgA	gA
parAgA	gA
parigA	gA
anuparigA	gA
viparigA	gA
pragA	gA
apapragA	gA
upapragA	gA
pratigA	gA
vigA	gA
samgA	gA
prodgA	gA
aBipragA	gA
vipragA	gA
sampragA	gA
atigAh	gAh
aBigAh	gAh
avagAh	gAh
aByavagAh	gAh
vyavagAh	gAh
samAgAh	gAh
udgAh	gAh
upagAh	gAh
pragAh	gAh
aBipragAh	gAh
sampragAh	gAh
pratigAh	gAh
vigAh	gAh
pravigAh	gAh
samgAh	gAh
pratigu	gu
vigu	gu
samudguYj	guYj
anuguRay	guRay
anuguRaya	guRay
pariguRay	guRay
pariguRaya	guRay
praguRay	guRay
praguRaya	guRay
samguRay	guRay
samguRaya	guRay
avaguRW	guRW
samavaguRW	guRW
AguRW	guRW
pariguRW	guRW
aDigup	gup
anugup	gup
aBigup	gup
upagup	gup
nirgup	gup
parigup	gup
pratigup	gup
vigup	gup
samgup	gup
aBisamgup	gup
atigur	gur
apagur	gur
aBigur	gur
avagur	gur
Agur	gur
udgur	gur
pragur	gur
apaguh	guh
samaBiguh	guh
avaguh	guh
samavaguh	guh
udguh	guh
upaguh	guh
samupaguh	guh
niguh	guh
viniguh	guh
pariguh	guh
viguh	guh
samguh	guh
anugfBAy	gfBAy
anugfBAya	gfBAy
samAgfBAy	gfBAy
samAgfBAya	gfBAy
udgfBAy	gfBAy
udgfBAya	gfBAy
pratigfBAy	gfBAy
pratigfBAya	gfBAy
samgfBAy	gfBAy
samgfBAya	gfBAy
AsamgfBAy	gfBAy
AsamgfBAya	gfBAy
aBigopay	gopay
aBigopaya	gopay
pragopay	gopay
pragopaya	gopay
samgopay	gopay
samgopaya	gopay
aBigopAy	gopAy
aBigopAya	gopAy
parigopAy	gopAy
parigopAya	gopAy
anugraT	graT
AgraT	graT
udgraT	graT
samudgraT	graT
upagraT	graT
nigraT	graT
pragraT	graT
vigraT	graT
samgraT	graT
atigraB	graB
atigrah	graB
anugraB	graB
anugrah	graB
samanugraB	graB
samanugrah	graB
apagraB	graB
apagrah	graB
apigraB	graB
apigrah	graB
aBigraB	graB
aBigrah	graB
avagraB	graB
avagrah	graB
pratyavagraB	graB
pratyavagrah	graB
vyavagraB	graB
vyavagrah	graB
AgraB	graB
Agrah	graB
upAgraB	graB
upAgrah	graB
samAgraB	graB
samAgrah	graB
udgraB	graB
udgrah	graB
upodgraB	graB
upodgrah	graB
pratyudgraB	graB
pratyudgrah	graB
samudgraB	graB
samudgrah	graB
upagraB	graB
upagrah	graB
nigraB	graB
nigrah	graB
upanigraB	graB
upanigrah	graB
pratinigraB	graB
pratinigrah	graB
vinigraB	graB
vinigrah	graB
saMnigraB	graB
saMnigrah	graB
nirgraB	graB
nirgrah	graB
pratinirgraB	graB
pratinirgrah	graB
parigraB	graB
parigrah	graB
saMparigraB	graB
saMparigrah	graB
pragraB	graB
pragrah	graB
paripragraB	graB
paripragrah	graB
pratipragraB	graB
pratipragrah	graB
sampragraB	graB
sampragrah	graB
pratigraB	graB
pratigrah	graB
upapratigraB	graB
upapratigrah	graB
sampratigraB	graB
sampratigrah	graB
vigraB	graB
vigrah	graB
samgraB	graB
samgrah	graB
anusamgraB	graB
anusamgrah	graB
apisamgraB	graB
apisamgrah	graB
aBisamgraB	graB
aBisamgrah	graB
upasamgraB	graB
upasamgrah	graB
pratisamgraB	graB
pratisamgrah	graB
sahagraB	graB
sahagrah	graB
aBigras	gras
Agras	gras
upagras	gras
parigras	gras
pragras	gras
samgras	gras
avaglA	glA
avaglE	glA
pariglA	glA
pariglE	glA
aBipariglA	glA
aBipariglE	glA
praglA	glA
praglE	glA
apaGaw	Gaw
AGaw	Gaw
udGaw	Gaw
samudGaw	Gaw
pariGaw	Gaw
praGaw	Gaw
viGaw	Gaw
samGaw	Gaw
anuGaww	Gaww
avaGaww	Gaww
AGaww	Gaww
udGaww	Gaww
upaGaww	Gaww
pariGaww	Gaww
viGaww	Gaww
pariviGaww	Gaww
samGaww	Gaww
aBiGar	Gar
pratyaBiGar	Gar
AGar	Gar
prAGar	Gar
vyAGar	Gar
viGar	Gar
avaGarz	Garz
avaGfz	Garz
AGarz	Garz
AGfz	Garz
udGarz	Garz
udGfz	Garz
samudGarz	Garz
samudGfz	Garz
niGarz	Garz
niGfz	Garz
saMniGarz	Garz
saMniGfz	Garz
nirGarz	Garz
nirGfz	Garz
pariGarz	Garz
pariGfz	Garz
praGarz	Garz
praGfz	Garz
sampraGarz	Garz
sampraGfz	Garz
viGarz	Garz
viGfz	Garz
samGarz	Garz
samGfz	Garz
apiGas	Gas
udGas	Gas
niGas	Gas
praGas	Gas
viGas	Gas
aBiGAtay	GAtay
aBiGAtaya	GAtay
avaGAtay	GAtay
avaGAtaya	GAtay
vyAGAtay	GAtay
vyAGAtaya	GAtay
upodGAtay	GAtay
upodGAtaya	GAtay
niGAtay	GAtay
niGAtaya	GAtay
nirGAtay	GAtay
nirGAtaya	GAtay
pratiGAtay	GAtay
pratiGAtaya	GAtay
viGAtay	GAtay
viGAtaya	GAtay
avaGuw	Guw
vyAGuw	Guw
anuGuz	Guz
avaGuz	Guz
AGuz	Guz
vyAGuz	Guz
udGuz	Guz
prodGuz	Guz
upaGuz	Guz
nirGuz	Guz
pariGuz	Guz
praGuz	Guz
viGuz	Guz
udviGuz	Guz
samGuz	Guz
parisamGuz	Guz
niGuz	Guz
avaGUrR	GUrR
AGUrR	GUrR
vyAGUrR	GUrR
viGUrR	GUrR
anuGrA	GrA
aBiGrA	GrA
avaGrA	GrA
AGrA	GrA
upAGrA	GrA
samupAGrA	GrA
vyAGrA	GrA
samAGrA	GrA
udGrA	GrA
upaGrA	GrA
samupaGrA	GrA
pariGrA	GrA
viGrA	GrA
samGrA	GrA
utcak	cak
pracak	cak
saMcakAs	cakAs
anucakz	cakz
aBicakz	cakz
avacakz	cakz
Acakz	cakz
anvAcakz	cakz
aByAcakz	cakz
udAcakz	cakz
nirAcakz	cakz
pratyAcakz	cakz
vyAcakz	cakz
samAcakz	cakz
paricakz	cakz
pracakz	cakz
aBipracakz	cakz
sampracakz	cakz
praticakz	cakz
vicakz	cakz
aBivicakz	cakz
udvicakz	cakz
pravicakz	cakz
saMcakz	cakz
avasaMcakz	cakz
parisaMcakz	cakz
prasaMcakz	cakz
utcaw	caw
vicaw	caw
niscat	cat
pracat	cat
vicat	cat
Acam	cam
anvAcam	cam
paryAcam	cam
samAcam	cam
vicam	cam
acCacar	car
aticar	car
vyaticar	car
aDicar	car
anucar	car
antarcar	car
apacar	car
aBicar	car
pratyaBicar	car
vyaBicar	car
avacar	car
anvavacar	car
aByavacar	car
Acar	car
aDyAcar	car
aByAcar	car
udAcar	car
aByudAcar	car
samudAcar	car
upAcar	car
samupAcar	car
upanyAcar	car
paryAcar	car
samAcar	car
anusamAcar	car
utcar	car
aByutcar	car
protcar	car
pratyutcar	car
vyutcar	car
anuvyutcar	car
samutcar	car
upacar	car
duScar	car
nicar	car
niscar	car
viniscar	car
parAcar	car
paricar	car
saMparicar	car
pracar	car
sampracar	car
praticar	car
vicar	car
anuvicar	car
aBivicar	car
parivicar	car
pravicar	car
sampravicar	car
anusaMvicar	car
saMcar	car
anusaMcar	car
aBisaMcar	car
upasaMcar	car
parisaMcar	car
pratisaMcar	car
visaMcar	car
AcaraRy	caraRy
AcaraRya	caraRy
utcaraRy	caraRy
utcaraRya	caraRy
vicarc	carc
aticart	cart
aticft	cart
avacart	cart
avacft	cart
Acart	cart
Acft	cart
upacart	cart
upacft	cart
nicart	cart
nicft	cart
niscart	cart
niscft	cart
paricart	cart
paricft	cart
pracart	cart
pracft	cart
vicart	cart
vicft	cart
saMcart	cart
saMcft	cart
Acal	cal
utcal	cal
protcal	cal
samutcal	cal
nical	cal
parical	cal
pracal	cal
sampracal	cal
vical	cal
anuvical	cal
pravical	cal
saMcal	cal
apacAy	cAy
nicAy	cAy
aDici	ci
anuci	ci
apaci	ci
avaci	ci
Aci	ci
anvAci	ci
avAci	ci
samAci	ci
utci	ci
aByutci	ci
samutci	ci
upaci	ci
samupaci	ci
nici	ci
pariRici	ci
saMnici	ci
parici	ci
praci	ci
sampraci	ci
vici	ci
saMvici	ci
saMci	ci
aBisaMci	ci
parisaMci	ci
nisci	ci
aBinisci	ci
parinisci	ci
vinisci	ci
pravici	ci
anucit	cit
apacit	cit
Acit	cit
pracit	cit
atipracit	cit
vicit	cit
pravicit	cit
saMcit	cit
utcitray	citray
utcitraya	citray
aticitrIy	citrIy
aticitrIya	citrIy
anucint	cint
samanucint	cint
aBicint	cint
vyAcint	cint
niscint	cint
paricint	cint
saMparicint	cint
pracint	cint
vipracint	cint
praticint	cint
vicint	cint
anuvicint	cint
pravicint	cint
saMvicint	cint
saMcint	cint
anusaMcint	cint
aBisaMcint	cint
aBicihnay	cihnay
aBicihnaya	cihnay
aBicud	cud
nicud	cud
paricud	cud
pracud	cud
aBipracud	cud
sampracud	cud
praticud	cud
saMcud	cud
nicup	cup
pracup	cup
vyaticumb	cumb
utcumb	cumb
paricumb	cumb
vicumb	cumb
avacUrRay	cUrRay
avacUrR	cUrRay
vinicUrRay	cUrRay
vinicUrR	cUrRay
pracUrRay	cUrRay
pracUrR	cUrRay
AcUz	cUz
saMcUz	cUz
aticezw	cezw
Acezw	cezw
samAcezw	cezw
paricezw	cezw
vicezw	cezw
pravicezw	cezw
saMcezw	cezw
apacyu	cyu
Acyu	cyu
utcyu	cyu
upacyu	cyu
niscyu	cyu
paricyu	cyu
pracyu	cyu
atipracyu	cyu
anupracyu	cyu
aBipracyu	cyu
sampracyu	cyu
praticyu	cyu
vicyu	cyu
saMcyu	cyu
anuCad	Cad
apacCad	Cad
aBicCad	Cad
samaBicCad	Cad
avacCad	Cad
samavacCad	Cad
ACad	Cad
samACad	Cad
utCad	Cad
apotCad	Cad
samutCad	Cad
upacCad	Cad
samupacCad	Cad
paricCad	Cad
pracCad	Cad
vipracCad	Cad
praticCad	Cad
vicCad	Cad
saMCad	Cad
ACard	Card
ACfd	Card
pracCard	Card
pracCfd	Card
upacCalay	Calay
upacCal	Calay
anuCA	CA
anuCo	CA
avacCA	CA
avacCo	CA
ACA	CA
ACo	CA
pracCA	CA
pracCo	CA
aticCid	Cid
antarCid	Cid
apacCid	Cid
samapacCid	Cid
avacCid	Cid
paryavacCid	Cid
vyavacCid	Cid
ACid	Cid
avACid	Cid
upACid	Cid
samACid	Cid
utCid	Cid
vyutCid	Cid
samutCid	Cid
paricCid	Cid
viparicCid	Cid
pracCid	Cid
saMpracCid	Cid
praticCid	Cid
vicCid	Cid
saMCid	Cid
ACuw	Cuw
pracCuq	Cuq
avacCur	Cur
ACur	Cur
vicCur	Cur
apajakz	jakz
parijakz	jakz
prajakz	jakz
pratijakz	jakz
vijakz	jakz
vyatijan	jan
aDijan	jan
anujan	jan
samanujan	jan
apajan	jan
apijan	jan
aBijan	jan
samaBijan	jan
avajan	jan
Ajan	jan
udAjan	jan
pratyAjan	jan
udjan	jan
upajan	jan
samupajan	jan
nirjan	jan
parijan	jan
prajan	jan
anuprajan	jan
apaprajan	jan
aBiprajan	jan
upaprajan	jan
praprajan	jan
samprajan	jan
pratijan	jan
vijan	jan
samjan	jan
aBisamjan	jan
upasamjan	jan
pratisamjan	jan
aBijap	jap
Ajap	jap
upajap	jap
parijap	jap
prajap	jap
pratijap	jap
samjap	jap
aBijaB	jaB
anujar	jar
anujf	jar
nirjar	jar
nirjf	jar
parijar	jar
parijf	jar
prajar	jar
prajf	jar
samjar	jar
samjf	jar
vyatijalp	jalp
anujalp	jalp
aBijalp	jalp
upajalp	jalp
parijalp	jalp
prajalp	jalp
pratijalp	jalp
vijalp	jalp
samjalp	jalp
udjas	jas
prodjas	jas
nijas	jas
atiji	ji
vyatiji	ji
aDiji	ji
anuji	ji
apaji	ji
aBiji	ji
pratyaBiji	ji
avaji	ji
Aji	ji
udji	ji
anUdji	ji
aByudji	ji
upaji	ji
nirji	ji
aBinirji	ji
parinirji	ji
pratinirji	ji
vinirji	ji
parAji	ji
pariji	ji
praji	ji
pratiji	ji
viji	ji
samji	ji
Ajinv	jinv
prajinv	jinv
upaprajinv	jinv
atijIv	jIv
anujIv	jIv
AjIv	jIv
udjIv	jIv
aByudjIv	jIv
pratyudjIv	jIv
upajIv	jIv
prajIv	jIv
pratijIv	jIv
vijIv	jIv
samjIv	jIv
pratisamjIv	jIv
anujuz	juz
aBijuz	juz
avajuz	juz
samAjuz	juz
upajuz	juz
nirjuz	juz
prajuz	juz
pratijuz	juz
samjuz	juz
apijU	jU
prajU	jU
nijUrv	jUrv
samjUrv	jUrv
vijeh	jeh
atijYA	jYA
anujYA	jYA
aByanujYA	jYA
pratyaByanujYA	jYA
pratyanujYA	jYA
samanujYA	jYA
apajYA	jYA
aBijYA	jYA
pratyaBijYA	jYA
samaBijYA	jYA
avajYA	jYA
AjYA	jYA
aByAjYA	jYA
samAjYA	jYA
upajYA	jYA
samupajYA	jYA
praRijYA	jYA
nirjYA	jYA
vinirjYA	jYA
parijYA	jYA
prajYA	jYA
anuprajYA	jYA
aBiprajYA	jYA
pratiprajYA	jYA
samprajYA	jYA
pratijYA	jYA
sampratijYA	jYA
vijYA	jYA
aBivijYA	jYA
pravijYA	jYA
prativijYA	jYA
saMvijYA	jYA
samjYA	jYA
aBisamjYA	jYA
pratisamjYA	jYA
aDijyA	jyA
upajyA	jyA
parijyA	jyA
prajyA	jyA
avajyut	jyut
avajramB	jramB
avajfmB	jramB
aBijramB	jramB
aBijfmB	jramB
vyAjramB	jramB
vyAjfmB	jramB
udjramB	jramB
udjfmB	jramB
samudjramB	jramB
samudjfmB	jramB
parijramB	jramB
parijfmB	jramB
prajramB	jramB
prajfmB	jramB
vijramB	jramB
vijfmB	jramB
pravijramB	jramB
pravijfmB	jramB
samjramB	jramB
samjfmB	jramB
upajri	jri
parijri	jri
prajvar	jvar
samjvar	jvar
anusamjvar	jvar
aBisamjvar	jvar
apajval	jval
aBijval	jval
avajval	jval
aByavajval	jval
udjval	jval
prodjval	jval
samudjval	jval
upajval	jval
prajval	jval
atiprajval	jval
aBiprajval	jval
samprajval	jval
pratijval	jval
aBivijval	jval
samjval	jval
udJaw	Jaw
utwaNkay	waNkay
utwaNk	waNkay
niswaNkay	waNkay
niswaNk	waNkay
viwaNkay	waNkay
viwaNk	waNkay
AwIk	wIk
utwIk	wIk
viqamb	qamb
atiqI	qI
aBiqI	qI
avaqI	qI
uqqI	qI
proqqI	qI
niqI	qI
nirqI	qI
parAqI	qI
pariqI	qI
praqI	qI
viqI	qI
samqI	qI
avasamqI	qI
upaQOk	QOk
aBitaMs	taMs
AtaMs	taMs
upataMs	taMs
nistaMs	taMs
parAtaMs	taMs
vitaMs	taMs
nistak	tak
paritak	tak
pratak	tak
anutakz	takz
apatakz	takz
avatakz	takz
Atakz	takz
nistakz	takz
pratakz	takz
vitakz	takz
saMtakz	takz
prataNk	taNk
AtaYc	taYc
aByAtaYc	taYc
upAtaYc	taYc
aBitaq	taq
avataq	taq
Ataq	taq
paritaq	taq
prataq	taq
vitaq	taq
saMtaq	taq
atitan	tan
vyatitan	tan
aDitan	tan
anutan	tan
apatan	tan
aBitan	tan
avatan	tan
aByavatan	tan
Atan	tan
anvAtan	tan
aByAtan	tan
udAtan	tan
paryAtan	tan
pratyAtan	tan
vyAtan	tan
samAtan	tan
uttan	tan
nitan	tan
atinistan	tan
paritan	tan
pratan	tan
aBipratan	tan
vitan	tan
anuvitan	tan
aBivitan	tan
Avitan	tan
pravitan	tan
saMtan	tan
anusaMtan	tan
aBisaMtan	tan
upasaMtan	tan
parisaMtan	tan
atitap	tap
anutap	tap
apratyanutap	tap
samanutap	tap
aBitap	tap
avatap	tap
Atap	tap
aByAtap	tap
uttap	tap
upatap	tap
samupatap	tap
nitap	tap
nistap	tap
vinistap	tap
paritap	tap
viparitap	tap
pratap	tap
aBipratap	tap
asampratap	tap
pratitap	tap
vitap	tap
pravitap	tap
saMtap	tap
atisaMtap	tap
aBisaMtap	tap
parisaMtap	tap
avatam	tam
Atam	tam
uttam	tam
nitam	tam
paritam	tam
pratam	tam
atipratam	tam
saMtam	tam
atitar	tar
atitF	tar
vyatitar	tar
vyatitF	tar
anutar	tar
anutF	tar
apatar	tar
apatF	tar
aBitar	tar
aBitF	tar
avatar	tar
avatF	tar
samavatar	tar
samavatF	tar
Atar	tar
AtF	tar
aByAtar	tar
aByAtF	tar
uttar	tar
uttF	tar
aByuttar	tar
aByuttF	tar
prottar	tar
prottF	tar
pratyuttar	tar
pratyuttF	tar
samuttar	tar
samuttF	tar
upatar	tar
upatF	tar
nitar	tar
nitF	tar
nistar	tar
nistF	tar
paritar	tar
paritF	tar
pratar	tar
pratF	tar
aBipratar	tar
aBipratF	tar
upapratar	tar
upapratF	tar
vipratar	tar
vipratF	tar
sampratar	tar
sampratF	tar
pratitar	tar
pratitF	tar
vitar	tar
vitF	tar
pravitar	tar
pravitF	tar
saMtar	tar
saMtF	tar
anusaMtar	tar
anusaMtF	tar
aBisaMtar	tar
aBisaMtF	tar
anutark	tark
nistark	tark
paritark	tark
pratark	tark
sampratark	tark
pratitark	tark
vitark	tark
saMvitark	tark
saMtark	tark
aBitarj	tarj
samaBitarj	tarj
Atarj	tarj
uttarj	tarj
paritarj	tarj
vitarj	tarj
saMtarj	tarj
atitard	tard
atitfd	tard
anutard	tard
anutfd	tard
aBitard	tard
aBitfd	tard
avatard	tard
avatfd	tard
Atard	tard
Atfd	tard
uttard	tard
uttfd	tard
upatard	tard
upatfd	tard
nitard	tard
nitfd	tard
paritard	tard
paritfd	tard
pratard	tard
pratfd	tard
sampratard	tard
sampratfd	tard
vitard	tard
vitfd	tard
saMtard	tard
saMtfd	tard
atitarp	tarp
atitfp	tarp
anutarp	tarp
anutfp	tarp
apatarp	tarp
apatfp	tarp
aBitarp	tarp
aBitfp	tarp
avatarp	tarp
avatfp	tarp
Atarp	tarp
Atfp	tarp
nitarp	tarp
nitfp	tarp
paritarp	tarp
paritfp	tarp
pratarp	tarp
pratfp	tarp
vitarp	tarp
vitfp	tarp
saMtarp	tarp
saMtfp	tarp
anutarz	tarz
anutfz	tarz
paritarz	tarz
paritfz	tarz
vitarz	tarz
vitfz	tarz
nistarh	tarh
nistfh	tarh
vitarh	tarh
vitfh	tarh
vitAy	tAy
saMtAy	tAy
uttij	tij
nitij	tij
pratitij	tij
saMtij	tij
pratil	til
uttu	tu
saMtu	tu
Atuj	tuj
anutud	tud
avatud	tud
Atud	tud
uttud	tud
nitud	tud
anunitud	tud
nistud	tud
paritud	tud
pratud	tud
pratitud	tud
vitud	tud
saMtud	tud
pratump	tump
praturv	turv
Atul	tul
uttul	tul
saMtul	tul
nituS	tuS
aBituz	tuz
upatuz	tuz
parituz	tuz
pratuz	tuz
sampratuz	tuz
saMtuz	tuz
aBityaj	tyaj
samaBityaj	tyaj
nityaj	tyaj
nistyaj	tyaj
parityaj	tyaj
saMparityaj	tyaj
vityaj	tyaj
saMtyaj	tyaj
aBisaMtyaj	tyaj
apatrap	trap
vyapatrap	trap
apatras	tras
avatras	tras
uttras	tras
vyuttras	tras
samuttras	tras
nistras	tras
parAtras	tras
paritras	tras
pratras	tras
vitras	tras
saMtras	tras
aBisaMtras	tras
paritrA	trA
paritrE	trA
saMtrA	trA
saMtrE	trA
uttruw	truw
pratvakz	tvakz
atitvar	tvar
aBitvar	tvar
paritvar	tvar
pratvar	tvar
saMtvar	tvar
Atviz	tviz
aBitsar	tsar
avatsar	tsar
upatsar	tsar
avadaMS	daMS
AdaMS	daMS
uddaMS	daMS
upadaMS	daMS
nirdaMS	daMS
paridaMS	daMS
vidaMS	daMS
samdaMS	daMS
aBisamdaMS	daMS
atidaMh	daMh
atidaG	daG
AdaG	daG
pradaG	daG
aBidaB	daB
AdaB	daB
upadaB	daB
Adam	dam
uddam	dam
pradam	dam
avaday	day
viday	day
anudar	dar
anudF	dar
apadar	dar
apadF	dar
avadar	dar
avadF	dar
vyavadar	dar
vyavadF	dar
Adar	dar
AdF	dar
uddar	dar
uddF	dar
nidar	dar
nidF	dar
nirdar	dar
nirdF	dar
paridar	dar
paridF	dar
pradar	dar
pradF	dar
aBipradar	dar
aBipradF	dar
pratidar	dar
pratidF	dar
vidar	dar
vidF	dar
udvidar	dar
udvidF	dar
pravidar	dar
pravidF	dar
Adar	dar
Adf	dar
atyAdar	dar
atyAdf	dar
pratyAdar	dar
pratyAdf	dar
samAdar	dar
samAdf	dar
atidarp	darp
atidfp	darp
samuddarp	darp
samuddfp	darp
pradarp	darp
pradfp	darp
anudarB	darB
anudfB	darB
pidarB	darB
pidfB	darB
samdarB	darB
samdfB	darB
atidarS	darS
atidfS	darS
aDidarS	darS
aDidfS	darS
anudarS	darS
anudfS	darS
vyapadarS	darS
vyapadfS	darS
aBidarS	darS
aBidfS	darS
avadarS	darS
avadfS	darS
AdarS	darS
AdfS	darS
pratyAdarS	darS
pratyAdfS	darS
vyAdarS	darS
vyAdfS	darS
uddarS	darS
uddfS	darS
aByuddarS	darS
aByuddfS	darS
upadarS	darS
upadfS	darS
samupadarS	darS
samupadfS	darS
nidarS	darS
nidfS	darS
saMnidarS	darS
saMnidfS	darS
parAdarS	darS
parAdfS	darS
paridarS	darS
paridfS	darS
pradarS	darS
pradfS	darS
upapradarS	darS
upapradfS	darS
sampradarS	darS
sampradfS	darS
pratidarS	darS
pratidfS	darS
vidarS	darS
vidfS	darS
aBividarS	darS
aBividfS	darS
samdarS	darS
samdfS	darS
anusamdarS	darS
anusamdfS	darS
uddarh	darh
uddfh	darh
anUddarh	darh
anUddfh	darh
avadal	dal
uddal	dal
nirdal	dal
vidal	dal
samdal	dal
AdaSasy	daSasy
AdaSasya	daSasy
samdaSasy	daSasy
samdaSasya	daSasy
apadas	das
upadas	das
anUpadas	das
pradas	das
vidas	das
samdas	das
atidah	dah
anudah	dah
apadah	dah
apidah	dah
aBidah	dah
avadah	dah
Adah	dah
aByAdah	dah
upadah	dah
nidah	dah
nirdah	dah
anunirdah	dah
vinirdah	dah
paridah	dah
saMparidah	dah
pradah	dah
sampradah	dah
pratidah	dah
vidah	dah
samdah	dah
vyatisamdah	dah
anusamdah	dah
atidA	dA
anudA	dA
aBidA	dA
avadA	dA
aByavadA	dA
AdA	dA
anvAdA	dA
apAdA	dA
aByAdA	dA
samaByAdA	dA
udAdA	dA
upAdA	dA
aByupAdA	dA
samupAdA	dA
paryAdA	dA
prAdA	dA
pratyAdA	dA
vyAdA	dA
apavyAdA	dA
aBivyAdA	dA
samAdA	dA
uddA	dA
upadA	dA
nidA	dA
pariRidA	dA
praRidA	dA
nirdA	dA
parAdA	dA
paridA	dA
pradA	dA
atipradA	dA
anupradA	dA
upapradA	dA
pratipradA	dA
sampradA	dA
pratidA	dA
vidA	dA
samdA	dA
apidA	dA
niravadA	dA
paryavadA	dA
pratyavadA	dA
vyavadA	dA
samavadA	dA
pariRIdA	dA
atidAS	dAS
vidAS	dAS
aBidAs	dAs
atidiv	div
aDidiv	div
aBidiv	div
Adiv	div
pradiv	div
pratidiv	div
vidiv	div
paridiv	div
atidiS	diS
aDidiS	diS
anudiS	diS
samanudiS	diS
apadiS	diS
vyapadiS	diS
aBidiS	diS
avadiS	diS
samavadiS	diS
AdiS	diS
anvAdiS	diS
aByAdiS	diS
upAdiS	diS
nirAdiS	diS
pratyAdiS	diS
vyAdiS	diS
samAdiS	diS
pratisamAdiS	diS
uddiS	diS
aByuddiS	diS
samuddiS	diS
upadiS	diS
pratyupadiS	diS
samupadiS	diS
nidiS	diS
nirdiS	diS
aBinirdiS	diS
pratinirdiS	diS
vinirdiS	diS
parAdiS	diS
paridiS	diS
pradiS	diS
aBipradiS	diS
sampradiS	diS
pratidiS	diS
samdiS	diS
anusamdiS	diS
pratisamdiS	diS
anudih	dih
aBidih	dih
avadih	dih
Adih	dih
uddih	dih
upadih	dih
nidih	dih
pariRidih	dih
nirdih	dih
paridih	dih
pradih	dih
samdih	dih
aBisamdih	dih
nirdI	dI
paridI	dI
upadI	dI
aBidIkz	dIkz
upadIkz	dIkz
samdIkz	dIkz
anudIDi	dIDi
anudIDI	dIDi
aBidIDi	dIDi
aBidIDI	dIDi
avadIDi	dIDi
avadIDI	dIDi
AdIDi	dIDi
AdIDI	dIDi
anvAdIDi	dIDi
anvAdIDI	dIDi
uddIDi	dIDi
uddIDI	dIDi
nidIDi	dIDi
nidIDI	dIDi
pradIDi	dIDi
pradIDI	dIDi
pratidIDi	dIDi
pratidIDI	dIDi
vidIDi	dIDi
vidIDI	dIDi
atidIp	dIp
aBidIp	dIp
avadIp	dIp
AdIp	dIp
upAdIp	dIp
vyAdIp	dIp
uddIp	dIp
pratyuddIp	dIp
samuddIp	dIp
upadIp	dIp
paridIp	dIp
pradIp	dIp
sampradIp	dIp
pratidIp	dIp
vidIp	dIp
samdIp	dIp
aBidu	du
Adu	du
paridu	du
pradu	du
vidu	du
paridurmanAy	durmanAy
paridurmanAya	durmanAy
anuduz	duz
aBiduz	duz
upaduz	duz
praduz	duz
vipraduz	duz
sampraduz	duz
viduz	duz
samduz	duz
aBiduh	duh
avaduh	duh
aByavaduh	duh
Aduh	duh
upaduh	duh
nirduh	duh
praduh	duh
viduh	duh
pratiduh	duh
samduh	duh
aBidUzay	dUzay
aBidUzaya	dUzay
upadUzay	dUzay
upadUzaya	dUzay
pradUzay	dUzay
pradUzaya	dUzay
aBipradUzay	dUzay
aBipradUzaya	dUzay
pratipradUzay	dUzay
pratipradUzaya	dUzay
vidUzay	dUzay
vidUzaya	dUzay
samdUzay	dUzay
samdUzaya	dUzay
pradyu	dyu
aBidyut	dyut
avadyut	dyut
Adyut	dyut
uddyut	dyut
samuddyut	dyut
nirdyut	dyut
pradyut	dyut
sampradyut	dyut
vidyut	dyut
saMvidyut	dyut
samdyut	dyut
vyaBidyut	dyut
apadrA	drA
aBidrA	drA
vidrA	drA
avadrA	drA
nidrA	drA
pariRidrA	drA
uddrAq	drAq
acCadru	dru
atidru	dru
aDidru	dru
anudru	dru
samanudru	dru
apadru	dru
aBidru	dru
samaBidru	dru
vyavadru	dru
samavadru	dru
Adru	dru
anvAdru	dru
aByAdru	dru
udAdru	dru
paryAdru	dru
prAdru	dru
saMprAdru	dru
pratyAdru	dru
samAdru	dru
uddru	dru
anUddru	dru
aByuddru	dru
upadru	dru
opadru	dru
pratyupadru	dru
samupadru	dru
nirdru	dru
paridru	dru
viparidru	dru
pradru	dru
aBipradru	dru
vipradru	dru
sampradru	dru
pratidru	dru
vidru	dru
aBividru	dru
pravidru	dru
samdru	dru
aBidruh	druh
pradruh	druh
pratidruh	druh
vidruh	druh
pradrek	drek
anudviz	dviz
paridviz	dviz
pradviz	dviz
vidviz	dviz
samdviz	dviz
praDan	Dan
acCaDanv	Danv
anuDanv	Danv
aBiDanv	Danv
praDanv	Danv
paripraDanv	Danv
samDanv	Danv
anuDam	Dam
apaDam	Dam
apiDam	Dam
aBiDam	Dam
avaDam	Dam
ADam	Dam
atyADam	Dam
upADam	Dam
pratyADam	Dam
samADam	Dam
udDam	Dam
upaDam	Dam
nirDam	Dam
parADam	Dam
praDam	Dam
viDam	Dam
samDam	Dam
aBisamDam	Dam
aDiDar	Dar
aDiDf	Dar
aBiDar	Dar
aBiDf	Dar
avaDar	Dar
avaDf	Dar
paryavaDar	Dar
paryavaDf	Dar
vyavaDar	Dar
vyavaDf	Dar
ADar	Dar
ADf	Dar
nyADar	Dar
nyADf	Dar
udDar	Dar
udDf	Dar
upaDar	Dar
upaDf	Dar
anUpaDar	Dar
anUpaDf	Dar
niDar	Dar
niDf	Dar
viniDar	Dar
viniDf	Dar
nirDar	Dar
nirDf	Dar
pariDar	Dar
pariDf	Dar
praDar	Dar
praDf	Dar
sampraDar	Dar
sampraDf	Dar
pratiDar	Dar
pratiDf	Dar
viDar	Dar
viDf	Dar
samDar	Dar
samDf	Dar
apaDarz	Darz
apaDfz	Darz
aBiDarz	Darz
aBiDfz	Darz
avaDarz	Darz
avaDfz	Darz
ADarz	Darz
ADfz	Darz
upaDarz	Darz
upaDfz	Darz
pariDarz	Darz
pariDfz	Darz
praDarz	Darz
praDfz	Darz
aBipraDarz	Darz
aBipraDfz	Darz
sampraDarz	Darz
sampraDfz	Darz
pratiDarz	Darz
pratiDfz	Darz
viDarz	Darz
viDfz	Darz
samDarz	Darz
samDfz	Darz
niDav	Dav
atiDA	DA
aDiDA	DA
anuDA	DA
vyanuDA	DA
antarDA	DA
apaDA	DA
apiDA	DA
samapiDA	DA
aBiDA	DA
pratyaBiDA	DA
samaBiDA	DA
avaDA	DA
anvavaDA	DA
aByavaDA	DA
upAvaDA	DA
paryavaDA	DA
pratyavaDA	DA
vyavaDA	DA
saMvyavaDA	DA
samavaDA	DA
ADA	DA
atyADA	DA
aDyADA	DA
antarADA	DA
anvADA	DA
apADA	DA
aByADA	DA
udADA	DA
upADA	DA
pratyupADA	DA
nyADA	DA
nirADA	DA
paryADA	DA
anuparyADA	DA
aBiparyADA	DA
prADA	DA
vyADA	DA
samADA	DA
anusamADA	DA
aBisamADA	DA
upasamADA	DA
pratisamADA	DA
udDA	DA
upaDA	DA
anUpaDA	DA
aByupaDA	DA
pratyupaDA	DA
tirarDA	DA
niDA	DA
aDiniDA	DA
apaniDA	DA
aBiniDA	DA
unniDA	DA
upaniDA	DA
pariniDA	DA
praRiDA	DA
sampraRiDA	DA
pratiniDA	DA
viniDA	DA
saMniDA	DA
nirDA	DA
vinirDA	DA
pariDA	DA
vipariDA	DA
piDA	DA
purarDA	DA
praDA	DA
pratiDA	DA
anupratiDA	DA
viDA	DA
ativiDA	DA
aDiviDA	DA
anuviDA	DA
aBiviDA	DA
praviDA	DA
prativiDA	DA
saMviDA	DA
samDA	DA
atisamDA	DA
aDisamDA	DA
anusamDA	DA
aBisamDA	DA
samaBisamDA	DA
upasamDA	DA
prasamDA	DA
pratisamDA	DA
visamDA	DA
niravaDA	DA
pariRiDA	DA
atiDAv	DAv
anuDAv	DAv
samanuDAv	DAv
apaDAv	DAv
apiDAv	DAv
aBiDAv	DAv
pratyaBiDAv	DAv
samaBiDAv	DAv
avaDAv	DAv
vyavaDAv	DAv
ADAv	DAv
anvADAv	DAv
upADAv	DAv
samADAv	DAv
upaDAv	DAv
samupaDAv	DAv
nirDAv	DAv
parADAv	DAv
pariDAv	DAv
vipariDAv	DAv
praDAv	DAv
aDipraDAv	DAv
anupraDAv	DAv
vipraDAv	DAv
sampraDAv	DAv
pratiDAv	DAv
viDAv	DAv
anuviDAv	DAv
aBiviDAv	DAv
pariviDAv	DAv
samDAv	DAv
vyudDAv	DAv
niDAv	DAv
aBiDi	Di
ADI	DI
niDI	DI
ADunay	Dunay
ADunaya	Dunay
apaDU	DU
aBiDU	DU
avaDU	DU
vyavaDU	DU
ADU	DU
vyADU	DU
samADU	DU
udDU	DU
samudDU	DU
upaDU	DU
niDU	DU
nirDU	DU
vinirDU	DU
pravinirDU	DU
pariDU	DU
praDU	DU
viDU	DU
anuviDU	DU
AviDU	DU
praviDU	DU
samDU	DU
avaDUnay	DUnay
avaDUnaya	DUnay
viDUnay	DUnay
viDUnaya	DUnay
anuDUpay	DUpay
anuDUpaya	DUpay
avaDUpay	DUpay
avaDUpaya	DUpay
ADUpay	DUpay
ADUpaya	DUpay
udDUpay	DUpay
udDUpaya	DUpay
upaDUpay	DUpay
upaDUpaya	DUpay
nirDUpay	DUpay
nirDUpaya	DUpay
praDUpay	DUpay
praDUpaya	DUpay
viDUpay	DUpay
viDUpaya	DUpay
viDUpAy	DUpAy
viDUpAya	DUpAy
ADUmay	DUmay
ADUmaya	DUmay
praDUmay	DUmay
praDUmaya	DUmay
avaDUlay	DUlay
avaDUlaya	DUlay
udDUlay	DUlay
udDUlaya	DUlay
atiDyA	DyA
atiDyE	DyA
anuDyA	DyA
anuDyE	DyA
samanuDyA	DyA
samanuDyE	DyA
apaDyA	DyA
apaDyE	DyA
samapaDyA	DyA
samapaDyE	DyA
aBiDyA	DyA
aBiDyE	DyA
samaBiDyA	DyA
samaBiDyE	DyA
avaDyA	DyA
avaDyE	DyA
ADyA	DyA
ADyE	DyA
samADyA	DyA
samADyE	DyA
upaDyA	DyA
upaDyE	DyA
niDyA	DyA
niDyE	DyA
aBiniDyA	DyA
aBiniDyE	DyA
praRiDyA	DyA
praRiDyE	DyA
nirDyA	DyA
nirDyE	DyA
pariDyA	DyA
pariDyE	DyA
praDyA	DyA
praDyE	DyA
sampraDyA	DyA
sampraDyE	DyA
pratiDyA	DyA
pratiDyE	DyA
samDyA	DyA
samDyE	DyA
praDraj	Draj
atiDvaMs	DvaMs
anuDvaMs	DvaMs
apaDvaMs	DvaMs
aBiDvaMs	DvaMs
avaDvaMs	DvaMs
ADvaMs	DvaMs
udDvaMs	DvaMs
samudDvaMs	DvaMs
upaDvaMs	DvaMs
niDvaMs	DvaMs
viniDvaMs	DvaMs
pariDvaMs	DvaMs
praDvaMs	DvaMs
pratiDvaMs	DvaMs
viDvaMs	DvaMs
praviDvaMs	DvaMs
apaDvan	Dvan
aBiDvan	Dvan
praDvan	Dvan
pratiDvan	Dvan
acCanakz	nakz
aBinakz	nakz
avanakz	nakz
upanakz	nakz
pariRakz	nakz
praRakz	nakz
aBipraRakz	nakz
unnaw	naw
anunad	nad
vyanunad	nad
aBinad	nad
Anad	nad
unnad	nad
pronnad	nad
samunnad	nad
upanad	nad
ninad	nad
pariRinad	nad
pariRad	nad
praRad	nad
aBipraRad	nad
vipraRad	nad
sampraRad	nad
pratinad	nad
vinad	nad
anuvinad	nad
saMnad	nad
anunand	nand
aBinand	nand
pratyaBinand	nand
samaBinand	nand
Anand	nand
samAnand	nand
pariRand	nand
pratinand	nand
sampratinand	nand
vinand	nand
unnaB	naB
praRaB	naB
atinam	nam
aDinam	nam
anunam	nam
apanam	nam
aBinam	nam
avanam	nam
aByavanam	nam
upAvanam	nam
Anam	nam
unnam	nam
aByunnam	nam
samaByunnam	nam
pronnam	nam
pratyunnam	nam
samunnam	nam
upanam	nam
samupanam	nam
ninam	nam
nirnam	nam
aBinirnam	nam
pariRam	nam
vipariRam	nam
praRam	nam
aBipraRam	nam
sampraRam	nam
pratinam	nam
vinam	nam
saMnam	nam
aBisaMnam	nam
upasaMnam	nam
saMnamasy	namasy
saMnamasya	namasy
aDinart	nart
aDinft	nart
anunart	nart
anunft	nart
aBinart	nart
aBinft	nart
Anart	nart
Anft	nart
aByAnart	nart
aByAnft	nart
upanart	nart
upanft	nart
ninart	nart
ninft	nart
aBininart	nart
aBininft	nart
pariRart	nart
pariRft	nart
praRart	nart
praRft	nart
sampranart	nart
sampranft	nart
pratinart	nart
pratinft	nart
vinart	nart
vinft	nart
saMnart	nart
saMnft	nart
aBinard	nard
avanard	nard
Anard	nard
ninard	nard
praRard	nard
pratinard	nard
vinard	nard
anuvinard	nard
saMnard	nard
anunaS	naS
apanaS	naS
vyapanaS	naS
avanaS	naS
nirnaS	naS
pariRaS	naS
praRaS	naS
atipraRaS	naS
vipraRaS	naS
sampraRaS	naS
vinaS	naS
anuvinaS	naS
pravinaS	naS
saMnaS	naS
acCanaS	naS
aBinaS	naS
unnaS	naS
saMnas	nas
anunah	nah
apanah	nah
apinah	nah
aBinah	nah
avanah	nah
paryavanah	nah
prAvanah	nah
Anah	nah
upAnah	nah
nirAnah	nah
paryAnah	nah
prAnah	nah
pratyAnah	nah
vyAnah	nah
unnah	nah
samunnah	nah
upanah	nah
ninah	nah
pariRah	nah
pratinah	nah
vinah	nah
saMnah	nah
apisaMnah	nah
aBisaMnah	nah
upasaMnah	nah
anunAT	nAT
upanAT	nAT
pariRiMs	niMs
praRiMs	niMs
anunikz	nikz
praRikz	nikz
vinikz	nikz
avanij	nij
aByavanij	nij
prAvanij	nij
pratyavanij	nij
nirnij	nij
parinirnij	nij
praRij	nij
vinij	nij
parininid	nid
praRid	nid
pratinid	nid
vinid	nid
acCanI	nI
atinI	nI
aByatinI	nI
vyatinI	nI
aDinI	nI
anunI	nI
paryanunI	nI
pratyanunI	nI
apanI	nI
vyapanI	nI
apinI	nI
aBinI	nI
prABinI	nI
avanI	nI
aByavanI	nI
AnI	nI
anvAnI	nI
aByAnI	nI
samaByAnI	nI
udAnI	nI
aByudAnI	nI
samudAnI	nI
upAnI	nI
samupAnI	nI
nyAnI	nI
paryAnI	nI
prAnI	nI
pratyAnI	nI
vyAnI	nI
samAnI	nI
pratisamAnI	nI
unnI	nI
anunnI	nI
aByunnI	nI
uponnI	nI
pronnI	nI
samunnI	nI
upanI	nI
vyupanI	nI
samupanI	nI
ninI	nI
aBininI	nI
avaninI	nI
upaninI	nI
saMninI	nI
nirnI	nI
vinirnI	nI
parAnI	nI
pratiparAnI	nI
upasaMparAnI	nI
pariRI	nI
anupariRI	nI
prapariRI	nI
vipariRI	nI
praRI	nI
atipraRI	nI
aBipraRI	nI
vipraRI	nI
sampranI	nI
pratinI	nI
vinI	nI
aBivinI	nI
prativinI	nI
saMvinI	nI
saMnI	nI
aBisaMnI	nI
acCanu	nu
anunu	nu
aBinu	nu
Anu	nu
anvAnu	nu
pariRu	nu
praRu	nu
aBipraRu	nu
sampranu	nu
pratinu	nu
vinu	nu
saMnu	nu
aBisaMnu	nu
atinu	nu
apanu	nu
avanu	nu
atinud	nud
apanud	nud
vyapanud	nud
aBinud	nud
avanud	nud
paryavanud	nud
apAnud	nud
vyapAnud	nud
upAnud	nud
upanud	nud
nirnud	nud
aBinirnud	nud
parAnud	nud
pariRud	nud
praRud	nud
atipraRud	nud
anupraRud	nud
vipraRud	nud
sampranud	nud
pratinud	nud
vinud	nud
aBivinud	nud
saMnud	nud
upasaMnud	nud
atined	ned
pratinyUNKay	nyUNKay
pratinyUNKaya	nyUNKay
aBipac	pac
Apac	pac
utpac	pac
nipac	pac
praRipac	pac
paripac	pac
prapac	pac
aBiprapac	pac
samprapac	pac
vipac	pac
saMpac	pac
aBisaMpac	pac
avapaw	paw
Apaw	paw
utpaw	paw
samutpaw	paw
vinipaw	paw
vinispaw	paw
vipaw	paw
atipaW	paW
vyatipaW	paW
anupaW	paW
aBipaW	paW
utpaW	paW
nipaW	paW
paripaW	paW
prapaW	paW
vipaW	paW
saMpaW	paW
ApaR	paR
prapaR	paR
vipaR	paR
acCapat	pat
atipat	pat
anupat	pat
prapat	pat
vipat	pat
antarpat	pat
aBipat	pat
samaBipat	pat
avapat	pat
aByavapat	pat
Apat	pat
aByApat	pat
paryApat	pat
samApat	pat
utpat	pat
anUtpat	pat
aByutpat	pat
protpat	pat
samutpat	pat
upapat	pat
nipat	pat
aBinipat	pat
upanipat	pat
pariRipat	pat
praRipat	pat
pratinipat	pat
vinipat	pat
saMnipat	pat
nispat	pat
aBinispat	pat
vinispat	pat
parApat	pat
anuparApat	pat
paripat	pat
viparipat	pat
anuprapat	pat
nizprapat	pat
pratipat	pat
saMpat	pat
apipaT	paT
atipad	pad
anupad	pad
samanupad	pad
apapad	pad
apipad	pad
anvapipad	pad
aBipad	pad
samaBipad	pad
avapad	pad
paryavapad	pad
vyavapad	pad
Apad	pad
aByApad	pad
pratyApad	pad
vyApad	pad
samApad	pad
aBisamApad	pad
utpad	pad
upotpad	pad
protpad	pad
pratyutpad	pad
vyutpad	pad
samutpad	pad
upapad	pad
aDyupapad	pad
aByupapad	pad
pratyupapad	pad
samupapad	pad
nipad	pad
anunipad	pad
aBinipad	pad
upanipad	pad
pariRipad	pad
nispad	pad
anunispad	pad
aBinispad	pad
parinispad	pad
vinispad	pad
saMnispad	pad
paripad	pad
prapad	pad
atiprapad	pad
anuprapad	pad
aBiprapad	pad
samprapad	pad
aBisamprapad	pad
pratipad	pad
aBipratipad	pad
vipratipad	pad
sampratipad	pad
vipad	pad
saMpad	pad
aBisaMpad	pad
upasaMpad	pad
Apan	pan
vipan	pan
aBipar	par
aBipf	par
samaBipar	par
samaBipf	par
avapar	par
avapf	par
Apar	par
Apf	par
samApar	par
samApf	par
utpar	par
utpf	par
upapar	par
upapf	par
nipar	par
nipf	par
nispar	par
nispf	par
paripar	par
paripf	par
saMparipar	par
saMparipf	par
prapar	par
prapf	par
aBiprapar	par
aBiprapf	par
pratipar	par
pratipf	par
saMpar	par
saMpf	par
atipar	par
atipf	par
apapar	par
apapf	par
aDiparc	parc
aDipfc	parc
apiparc	parc
apipfc	parc
Aparc	parc
Apfc	parc
upaparc	parc
upapfc	parc
nisparc	parc
nispfc	parc
praparc	parc
prapfc	parc
viparc	parc
vipfc	parc
saMparc	parc
saMpfc	parc
atipaS	paS
anupaS	paS
samanupaS	paS
antarpaS	paS
apapaS	paS
aBipaS	paS
avapaS	paS
ApaS	paS
utpaS	paS
parApaS	paS
paripaS	paS
prapaS	paS
aBiprapaS	paS
samprapaS	paS
pratipaS	paS
vipaS	paS
anuvipaS	paS
aBivipaS	paS
saMpaS	paS
prasaMpaS	paS
atipA	pA
anupA	pA
antarpA	pA
aBipA	pA
avapA	pA
anvavapA	pA
ApA	pA
samApA	pA
utpA	pA
anUtpA	pA
upapA	pA
nipA	pA
vinipA	pA
nispA	pA
paripA	pA
prapA	pA
anuprapA	pA
pratipA	pA
vipA	pA
saMpA	pA
aDipA	pA
pratyutpA	pA
atipAlay	pAlay
atipAl	pAlay
anupAlay	pAlay
anupAl	pAlay
samanupAlay	pAlay
samanupAl	pAlay
aBipAlay	pAlay
aBipAl	pAlay
samaBipAlay	pAlay
samaBipAl	pAlay
nipAlay	pAlay
nipAl	pAlay
paripAlay	pAlay
paripAl	pAlay
saMparipAlay	pAlay
saMparipAl	pAlay
prapAlay	pAlay
prapAl	pAlay
pratipAlay	pAlay
pratipAl	pAlay
sampratipAlay	pAlay
sampratipAl	pAlay
saMpAlay	pAlay
saMpAl	pAlay
avapASay	pASay
avapASaya	pASay
vipASay	pASay
vipASaya	pASay
avapiRqay	piRqay
avapiRq	piRqay
utpiRqay	piRqay
utpiRq	piRqay
paripiRqay	piRqay
paripiRq	piRqay
saMpiRqay	piRqay
saMpiRq	piRqay
prapinv	pinv
Apibd	pibd
anupiS	piS
aBipiS	piS
ApiS	piS
nispiS	piS
vipiS	piS
anupiz	piz
avapiz	piz
Apiz	piz
utpiz	piz
samutpiz	piz
nipiz	piz
pranipiz	piz
nispiz	piz
vinispiz	piz
paripiz	piz
prapiz	piz
pratipiz	piz
aBipratipiz	piz
vipiz	piz
saMpiz	piz
aBipI	pI
ApI	pI
utpI	pI
prapI	pI
atipIq	pIq
aBipIq	pIq
samaBipIq	pIq
avapIq	pIq
samavapIq	pIq
ApIq	pIq
utpIq	pIq
samutpIq	pIq
upapIq	pIq
nipIq	pIq
aBinipIq	pIq
upanipIq	pIq
vinipIq	pIq
nispIq	pIq
vinispIq	pIq
paripIq	pIq
prapIq	pIq
aBiprapIq	pIq
samprapIq	pIq
pratipIq	pIq
vipIq	pIq
saMpIq	pIq
nipIy	pIy
avapuYjay	puYjay
avapuYjaya	puYjay
utpuYjay	puYjay
utpuYjaya	puYjay
paripuw	puw
saMpuw	puw
aBipuT	puT
avapuT	puT
ApuT	puT
samApuT	puT
nipuT	puT
prapuT	puT
vipuT	puT
saMpuT	puT
anupuz	puz
utpuz	puz
paripuz	puz
prapuz	puz
vipuz	puz
atipU	pU
anupU	pU
aBipU	pU
ApU	pU
samApU	pU
utpU	pU
samutpU	pU
nipU	pU
nispU	pU
pratinispU	pU
parApU	pU
paripU	pU
prapU	pU
vipU	pU
saMpU	pU
aBisaMpU	pU
anupUj	pUj
aBipUj	pUj
samaBipUj	pUj
paripUj	pUj
saMparipUj	pUj
prapUj	pUj
samprapUj	pUj
pratipUj	pUj
sampratipUj	pUj
saMpUj	pUj
aBisaMpUj	pUj
ApUy	pUy
ApyA	pyA
ApyE	pyA
pratyApyA	pyA
pratyApyE	pyA
samApyA	pyA
samApyE	pyA
prapyA	pyA
prapyE	pyA
atipraC	praC
anupraC	praC
aByanupraC	praC
samanupraC	praC
aBipraC	praC
ApraC	praC
upApraC	praC
samApraC	praC
upapraC	praC
paripraC	praC
saMparipraC	praC
pratipraC	praC
vipraC	praC
saMpraC	praC
upasaMpraC	praC
anupraT	praT
aBipraT	praT
ApraT	praT
nipraT	praT
paripraT	praT
vipraT	praT
saMpraT	praT
AprA	prA
viprA	prA
nipriyAy	priyAy
nipriyAya	priyAy
aBiprI	prI
AprI	prI
pariprI	prI
anupraprI	prI
saMprI	prI
atipru	pru
apapru	pru
Apru	pru
utpru	pru
vipru	pru
prapruT	pruT
aBipruz	pruz
utpruz	pruz
paripruz	pruz
aBipruzAy	pruzAy
aBipruz	pruzAy
ApruzAy	pruzAy
Apruz	pruzAy
samatiplu	plu
aDiplu	plu
anuplu	plu
apaplu	plu
aBiplu	plu
samaBiplu	plu
avaplu	plu
anvavaplu	plu
samavaplu	plu
Aplu	plu
udAplu	plu
nyAplu	plu
upanyAplu	plu
pariplu	plu
pratyAplu	plu
samAplu	plu
utplu	plu
samutplu	plu
upaplu	plu
samupaplu	plu
upaniplu	plu
nisplu	plu
anupariplu	plu
aBipariplu	plu
saMpariplu	plu
praplu	plu
pratiplu	plu
viplu	plu
anuviplu	plu
saMplu	plu
aBisaMplu	plu
Apluz	pluz
nispluz	pluz
vipluz	pluz
pariRipsA	psA
saMpsA	psA
APaR	PaR
utPal	Pal
protPal	Pal
samutPal	Pal
praPal	Pal
pratiPal	Pal
viPal	Pal
saMPal	Pal
avabaMh	baMh
nibaMh	baMh
sambaMh	baMh
anubanD	banD
paryanubanD	banD
samanubanD	banD
apibanD	banD
aBibanD	banD
avabanD	banD
AbanD	banD
samAbanD	banD
udbanD	banD
prodbanD	banD
samudabanD	banD
upabanD	banD
nibanD	banD
upanibanD	banD
vinibanD	banD
saMnibanD	banD
nirdanD	banD
paribanD	banD
prabanD	banD
pratibanD	banD
vibanD	banD
sambanD	banD
aBisambanD	banD
upasambanD	banD
pratisambanD	banD
atibarh	barh
atibfh	barh
avabarh	barh
avabfh	barh
Abarh	barh
Abfh	barh
udbarh	barh
udbfh	barh
samudbarh	barh
samudbfh	barh
nibarh	barh
nibfh	barh
vinibarh	barh
vinibfh	barh
saMnibarh	barh
saMnibfh	barh
nirdarh	barh
nirdfh	barh
paribarh	barh
paribfh	barh
prabarh	barh
prabfh	barh
upaprabarh	barh
upaprabfh	barh
vibarh	barh
vibfh	barh
udvibarh	barh
udvibfh	barh
sambarh	barh
sambfh	barh
aBibarh	barh
aBibfh	barh
upabarh	barh
upabfh	barh
samupabarh	barh
samupabfh	barh
atibAD	bAD
aDibAD	bAD
anubAD	bAD
apabAD	bAD
aBibAD	bAD
avabAD	bAD
AbAD	bAD
udbAD	bAD
upabAD	bAD
nibAD	bAD
nirdAD	bAD
prabAD	bAD
samprabAD	bAD
pratibAD	bAD
vibAD	bAD
sambAD	bAD
atibAzpAy	bAzpAy
atibAzpAya	bAzpAy
anubuD	buD
avabuD	buD
samavabuD	buD
AbuD	buD
udbuD	buD
prodbuD	buD
samudbuD	buD
nibuD	buD
saMnibuD	buD
paribuD	buD
prabuD	buD
anuprabuD	buD
viprabuD	buD
samprabuD	buD
pratibuD	buD
sampratibuD	buD
vibuD	buD
aBivibuD	buD
sambuD	buD
aBisambuD	buD
pratisambuD	buD
acCAbrU	brU
atibrU	brU
aDibrU	brU
anubrU	brU
apabrU	brU
aBibrU	brU
avabrU	brU
AbrU	brU
pratyAbrU	brU
udbrU	brU
upabrU	brU
nirdrU	brU
paribrU	brU
prabrU	brU
pratibrU	brU
vibrU	brU
sambrU	brU
vyavaBakz	Bakz
upaBakz	Bakz
pariBakz	Bakz
pratiBakz	Bakz
samBakz	Bakz
anuBaj	Baj
apaBaj	Baj
aBiBaj	Baj
ABaj	Baj
anvABaj	Baj
upaBaj	Baj
nirDaj	Baj
pariBaj	Baj
praBaj	Baj
pratiBaj	Baj
viBaj	Baj
anuviBaj	Baj
aBiviBaj	Baj
praviBaj	Baj
prativiBaj	Baj
saMviBaj	Baj
samBaj	Baj
apaBaYj	BaYj
aBiBaYj	BaYj
avaBaYj	BaYj
ABaYj	BaYj
vyABaYj	BaYj
udBaYj	BaYj
upaBaYj	BaYj
niBaYj	BaYj
nirDaYj	BaYj
pariBaYj	BaYj
praBaYj	BaYj
aBipraBaYj	BaYj
sampraBaYj	BaYj
pratiBaYj	BaYj
viBaYj	BaYj
samBaYj	BaYj
aBisamBaYj	BaYj
pratiBaR	BaR
pratiBaRq	BaRq
ABan	Ban
anuBar	Bar
anuBf	Bar
apaBar	Bar
apaBf	Bar
aBiBar	Bar
aBiBf	Bar
avaBar	Bar
avaBf	Bar
ABar	Bar
ABf	Bar
aDyABar	Bar
aDyABf	Bar
upABar	Bar
upABf	Bar
paryABar	Bar
paryABf	Bar
samABar	Bar
samABf	Bar
udBar	Bar
udBf	Bar
aDyudBar	Bar
aDyudBf	Bar
paryudBar	Bar
paryudBf	Bar
niBar	Bar
niBf	Bar
saMniBar	Bar
saMniBf	Bar
nirDar	Bar
nirDf	Bar
parABar	Bar
parABf	Bar
praBar	Bar
praBf	Bar
aBipraBar	Bar
aBipraBf	Bar
pratiBar	Bar
pratiBf	Bar
viBar	Bar
viBf	Bar
samBar	Bar
samBf	Bar
anusamBar	Bar
anusamBf	Bar
aBisamBar	Bar
aBisamBf	Bar
upasamBar	Bar
upasamBf	Bar
aBiBarts	Barts
avaBarts	Barts
niBarts	Barts
udBarts	Barts
nirDarts	Barts
aBinirDarts	Barts
pariBarts	Barts
samBarts	Barts
niBal	Bal
viniBal	Bal
nirDal	Bal
samBal	Bal
nirDas	Bas
praBas	Bas
atiBA	BA
naBA	BA
vyAtiBA	BA
anuBA	BA
aBiBA	BA
avaBA	BA
ABA	BA
samABA	BA
udBA	BA
niBA	BA
nirDA	BA
vinirDA	BA
praBA	BA
anupraBA	BA
pratiBA	BA
vipratiBA	BA
sampratiBA	BA
viBA	BA
aBiviBA	BA
saMviBA	BA
samBA	BA
aDiBAz	BAz
anuBAz	BAz
apaBAz	BAz
aBiBAz	BAz
pratyaBiBAz	BAz
samaBiBAz	BAz
avaBAz	BAz
ABAz	BAz
vyABAz	BAz
samABAz	BAz
udBAz	BAz
pariBAz	BAz
praBAz	BAz
sampraBAz	BAz
pratiBAz	BAz
sampratiBAz	BAz
viBAz	BAz
samBAz	BAz
upasamBAz	BAz
avaBAs	BAs
pratyavaBAs	BAs
vyavaBAs	BAs
ABAs	BAs
udBAs	BAs
samudBAs	BAs
nirDAs	BAs
pariBAs	BAs
praBAs	BAs
pratiBAs	BAs
viBAs	BAs
vyatiBid	Bid
anuBid	Bid
antarBid	Bid
apaBid	Bid
aBiBid	Bid
avaBid	Bid
ABid	Bid
udBid	Bid
prodBid	Bid
niBid	Bid
nirDid	Bid
vinirDid	Bid
parABid	Bid
pariBid	Bid
praBid	Bid
upapraBid	Bid
pratiBid	Bid
viBid	Bid
praviBid	Bid
samBid	Bid
anusamBid	Bid
upasamBid	Bid
atiBI	BI
ABI	BI
niBI	BI
pariBI	BI
praBI	BI
viBI	BI
samBI	BI
avaBuj	Buj
pratyavaBuj	Buj
ABuj	Buj
vyABuj	Buj
niBuj	Buj
nirDuj	Buj
vinirDuj	Buj
pariBuj	Buj
praBuj	Buj
viBuj	Buj
praviBuj	Buj
samBuj	Buj
aDiBuj	Buj
aBiBuj	Buj
samABuj	Buj
upaBuj	Buj
pratyupaBuj	Buj
samupaBuj	Buj
pratiBuj	Buj
pariBur	Bur
samBur	Bur
naBU	BU
kvaBU	BU
atiBU	BU
praBU	BU
vyatiBU	BU
aDiBU	BU
anuBU	BU
pratyanuBU	BU
samanuBU	BU
antarBU	BU
apaBU	BU
apiBU	BU
aBiBU	BU
atyaBiBU	BU
pratyaBiBU	BU
ABU	BU
anvABU	BU
aByABU	BU
paryABU	BU
pratyABU	BU
AvirDU	BU
prAvirDU	BU
udBU	BU
prodBU	BU
pratyudBU	BU
samudBU	BU
upaBU	BU
tirarDU	BU
niBU	BU
praRiBU	BU
nirDU	BU
parABU	BU
anuparABU	BU
pariBU	BU
saMpariBU	BU
punarBU	BU
anupraBU	BU
aBipraBU	BU
upapraBU	BU
pratiBU	BU
viBU	BU
anuviBU	BU
praviBU	BU
saMviBU	BU
anusamBU	BU
aBisamBU	BU
parisamBU	BU
pratisamBU	BU
upABUz	BUz
upaBUz	BUz
pariBUz	BUz
viBUz	BUz
atiBUz	BUz
aBiBUz	BUz
ABUz	BUz
praBUz	BUz
anupraBUz	BUz
pratiBUz	BUz
udByas	Byas
anuBraMS	BraMS
apaBraMS	BraMS
ABraMS	BraMS
niBraMS	BraMS
pariBraMS	BraMS
saMpariBraMS	BraMS
praBraMS	BraMS
viBraMS	BraMS
samBraMS	BraMS
avaBrajj	Brajj
pariBrajj	Brajj
samBrajj	Brajj
udBram	Bram
samudBram	Bram
upaBram	Bram
pariBram	Bram
praBram	Bram
viBram	Bram
samBram	Bram
upasamBram	Bram
praBrAj	BrAj
viBrAj	BrAj
aDiviBrAj	BrAj
samBrAj	BrAj
vimaMh	maMh
pramaNk	maNk
pramaNg	maNg
avamajj	majj
Amajj	majj
udmajj	majj
samudmajj	majj
upamajj	majj
nimajj	majj
upanimajj	majj
vinimajj	majj
nirmajj	majj
pramajj	majj
vimajj	majj
sammajj	majj
nirmaYc	maYc
parimaRq	maRq
pratimaRq	maRq
aDimaT	maT
aBimaT	maT
avamaT	maT
AmaT	maT
udmaT	maT
prodmaT	maT
samudmaT	maT
upamaT	maT
nimaT	maT
nirmaT	maT
vinirmaT	maT
saMnirmaT	maT
parimaT	maT
pramaT	maT
vimaT	maT
aBivimaT	maT
sammaT	maT
udmaTAy	maTAy
udmaTAya	maTAy
parimaTAy	maTAy
parimaTAya	maTAy
anumad	mad
aBimad	mad
avamad	mad
udmad	mad
prodmad	mad
upamad	mad
parimad	mad
pramad	mad
aBipramad	mad
vipramad	mad
sampramad	mad
vimad	mad
sammad	mad
nimad	mad
upanimad	mad
atiman	man
aDiman	man
anuman	man
samanuman	man
apaman	man
aBiman	man
avaman	man
aByavaman	man
Aman	man
pratyAman	man
samAman	man
upaman	man
niman	man
pariman	man
praman	man
aBipraman	man
pratiman	man
viman	man
samman	man
anusamman	man
aBisamman	man
aBimanasy	manasy
aBimanasya	manasy
anumantray	mantray
anumantr	mantray
aBimantray	mantray
aBimantr	mantray
samaBimantray	mantray
samaBimantr	mantray
Amantray	mantray
Amantr	mantray
udAmantray	mantray
udAmantr	mantray
upAmantray	mantray
upAmantr	mantray
samAmantray	mantray
samAmantr	mantray
upamantray	mantray
upamantr	mantray
aByupamantray	mantray
aByupamantr	mantray
nimantray	mantray
nimantr	mantray
aBinimantray	mantray
aBinimantr	mantray
upanimantray	mantray
upanimantr	mantray
saMnimantray	mantray
saMnimantr	mantray
parimantray	mantray
parimantr	mantray
pratimantray	mantray
pratimantr	mantray
sammantray	mantray
sammantr	mantray
anumar	mar
anumf	mar
aBimar	mar
aBimf	mar
Amar	mar
Amf	mar
upamar	mar
upamf	mar
parimar	mar
parimf	mar
pramar	mar
pramf	mar
nimar	mar
nimf	mar
aBipramar	mar
aBipramf	mar
vimar	mar
vimf	mar
aBimarC	marC
aBimfC	marC
anumarj	marj
anumfj	marj
apamarj	marj
apamfj	marj
aBimarj	marj
aBimfj	marj
Amarj	marj
Amfj	marj
apAmarj	marj
apAmfj	marj
vyAmarj	marj
vyAmfj	marj
udmarj	marj
udmfj	marj
samudmarj	marj
samudmfj	marj
upamarj	marj
upamfj	marj
nimarj	marj
nimfj	marj
nirmarj	marj
nirmfj	marj
parAmarj	marj
parAmfj	marj
pramarj	marj
pramfj	marj
vipramarj	marj
vipramfj	marj
pratimarj	marj
pratimfj	marj
vimarj	marj
vimfj	marj
anuvimarj	marj
anuvimfj	marj
aBivimarj	marj
aBivimfj	marj
saMmarj	marj
saMmfj	marj
pramarq	marq
pramfq	marq
atimard	mard
atimfd	mard
apamard	mard
apamfd	mard
aBimard	mard
aBimfd	mard
avamard	mard
avamfd	mard
Amard	mard
Amfd	mard
aByAmard	mard
aByAmfd	mard
vyAmard	mard
vyAmfd	mard
udmard	mard
udmfd	mard
upamard	mard
upamfd	mard
nimard	mard
nimfd	mard
parAmard	mard
parAmfd	mard
parimard	mard
parimfd	mard
pramard	mard
pramfd	mard
sampramard	mard
sampramfd	mard
pratimard	mard
pratimfd	mard
vimard	mard
vimfd	mard
saMvimard	mard
saMvimfd	mard
parimarD	marD
parimfD	marD
vimarD	marD
vimfD	marD
sammarD	marD
sammfD	marD
atimarS	marS
atimfS	marS
vyatimarS	marS
vyatimfS	marS
aByaDimarS	marS
aByaDimfS	marS
anumarS	marS
anumfS	marS
apamarS	marS
apamfS	marS
aBimarS	marS
aBimfS	marS
pratyaBimarS	marS
pratyaBimfS	marS
avamarS	marS
avamfS	marS
anvavamarS	marS
anvavamfS	marS
pratyavamarS	marS
pratyavamfS	marS
samavamarS	marS
samavamfS	marS
AmarS	marS
AmfS	marS
udmarS	marS
udmfS	marS
parAmarS	marS
parAmfS	marS
anuparAmarS	marS
anuparAmfS	marS
upopamarS	marS
upopamfS	marS
pratiparAmarS	marS
pratiparAmfS	marS
parimarS	marS
parimfS	marS
aBipramarS	marS
aBipramfS	marS
pratimarS	marS
pratimfS	marS
vimarS	marS
vimfS	marS
anuvimarS	marS
anuvimfS	marS
pravimarS	marS
pravimfS	marS
sammarS	marS
sammfS	marS
aBisammarS	marS
aBisammfS	marS
apamarz	marz
apamfz	marz
apimarz	marz
apimfz	marz
Amarz	marz
Amfz	marz
upamarz	marz
upamfz	marz
parimarz	marz
parimfz	marz
pramarz	marz
pramfz	marz
vimarz	marz
vimfz	marz
Amah	mah
sammah	mah
anumA	mA
apamA	mA
aBimA	mA
avamA	mA
udmA	mA
upamA	mA
nimA	mA
pariRimA	mA
aBinirmA	mA
parinirmA	mA
vinirmA	mA
pravinirmA	mA
saMnirmA	mA
parimA	mA
pramA	mA
pratimA	mA
vimA	mA
sammA	mA
AmA	mA
vinimA	mA
anumArg	mArg
parimArg	mArg
saMparimArg	mArg
pratimArg	mArg
anumi	mi
udmi	mi
upami	mi
nimi	mi
praRimi	mi
aBinirmi	mi
parimi	mi
prami	mi
pratimi	mi
vimi	mi
sammi	mi
Ami	mi
parAmi	mi
Amikz	mikz
sammikz	mikz
aBimiT	miT
pratyaBimiT	miT
atimid	mid
anumid	mid
pramid	mid
parimil	mil
sammil	mil
aBisammil	mil
vyatimiSray	miSray
vyatimiSr	miSray
anumiSray	miSray
anumiSr	miSray
vyAmiSray	miSray
vyAmiSr	miSray
vimiSray	miSray
vimiSr	miSray
sammiSray	miSray
sammiSr	miSray
pratisammiSray	miSray
pratisammiSr	miSray
udmiz	miz
prodmiz	miz
pratyudmiz	miz
samudmiz	miz
nimiz	miz
atimih	mih
aBimih	mih
avamih	mih
upamih	mih
nimih	mih
parimih	mih
pramih	mih
pratimih	mih
sammih	mih
anumI	mI
AmI	mI
udamI	mI
pramI	mI
anumIl	mIl
aBimIl	mIl
AmIl	mIl
vyAmIl	mIl
udmIl	mIl
prodmIl	mIl
samudmIl	mIl
nimIl	mIl
vinimIl	mIl
saMnimIl	mIl
pramIl	mIl
saMmIl	mIl
aBisammIl	mIl
AmIv	mIv
nimIv	mIv
pramIv	mIv
pratimIv	mIv
atimuc	muc
aDimuc	muc
vyapamuc	muc
aBimuc	muc
avamuc	muc
vyavamuc	muc
Amuc	muc
paryAmuc	muc
vyAmuc	muc
udmuc	muc
prodmuc	muc
samudmuc	muc
upamuc	muc
nirmuc	muc
aDinirmuc	muc
aBinirmuc	muc
vinirmuc	muc
parimuc	muc
viparimuc	muc
pramuc	muc
anupramuc	muc
paripramuc	muc
pratipramuc	muc
vipramuc	muc
sampramuc	muc
pratimuc	muc
sampratimuc	muc
vimuc	muc
pravimuc	muc
sammuc	muc
avamuw	muw
udmuw	muw
parimuw	muw
pratimuw	muw
anumud	mud
aByanumud	mud
aBimud	mud
Amud	mud
udmud	mud
saMparimud	mud
pramud	mud
anupramud	mud
sampramud	mud
pratimud	mud
sammud	mud
udmudray	mudray
udmudraya	mudray
parimudray	mudray
parimudraya	mudray
vimudray	mudray
vimudraya	mudray
avamuz	muz
Amuz	muz
udmuz	muz
nirmuz	muz
parimuz	muz
pramuz	muz
sampramuz	muz
vimuz	muz
sammuz	muz
AmuzAy	muzAy
AmuzAya	muzAy
pramuzAy	muzAy
pramuzAya	muzAy
atimuh	muh
vyatimuh	muh
anumuh	muh
aBimuh	muh
vyAmuh	muh
udmuh	muh
nirmuh	muh
vinirmuh	muh
parimuh	muh
pramuh	muh
vipramuh	muh
sampramuh	muh
pratimuh	muh
vimuh	muh
sammuh	muh
aBisammuh	muh
visammuh	muh
avamUtray	mUtray
avamUtraya	mUtray
pramUtray	mUtray
pramUtraya	mUtray
sammUtray	mUtray
sammUtraya	mUtray
aBimUrC	mUrC
avamUrC	mUrC
udmUrC	mUrC
prodmUrC	mUrC
pramUrC	mUrC
vimUrC	mUrC
sammUrC	mUrC
aBisammUrC	mUrC
parimfgay	mfgay
parimfg	mfgay
pramfgay	mfgay
pramfg	mfgay
vimfgay	mfgay
vimfg	mfgay
AmfR	mfR
pramfR	mfR
Amokzay	mokzay
Amokz	mokzay
parimokzay	mokzay
parimokz	mokzay
pramokzay	mokzay
pramokz	mokzay
sampramokzay	mokzay
sampramokz	mokzay
pratimokzay	mokzay
pratimokz	mokzay
vimokzay	mokzay
vimokz	mokzay
sammokzay	mokzay
sammokz	mokzay
AmnA	mnA
pratyAmnA	mnA
samAmnA	mnA
apamyakz	myakz
Amyakz	myakz
nimyakz	myakz
parAmyakz	myakz
sammyakz	myakz
aBimrakz	mrakz
nimrakz	mrakz
sammrakz	mrakz
pramrad	mrad
vimrad	mrad
nirmrit	mrit
vimrit	mrit
nimrit	mrit
aBinimrit	mrit
Amreq	mreq
upanimreq	mreq
aBimlA	mlA
aBimlE	mlA
AmlA	mlA
AmlE	mlA
parimlA	mlA
parimlE	mlA
viparimlA	mlA
viparimlE	mlA
pramlA	mlA
pramlE	mlA
vimlA	mlA
vimlE	mlA
anumluc	mluc
apamluc	mluc
upamluc	mluc
nimluc	mluc
aBinimluc	mluc
pramluc	mluc
atiyaj	yaj
anuyaj	yaj
apayaj	yaj
aBiyaj	yaj
avayaj	yaj
niravayaj	yaj
Ayaj	yaj
samAyaj	yaj
upayaj	yaj
atyupayaj	yaj
prayaj	yaj
pratiyaj	yaj
anuprayaj	yaj
samyaj	yaj
aDiyat	yat
anuyat	yat
Ayat	yat
atyAyat	yat
anvAyat	yat
vyAyat	yat
samAyat	yat
upayat	yat
niyat	yat
nisyat	yat
pratinisyat	yat
pariyat	yat
prayat	yat
samprayat	yat
pratiyat	yat
viyat	yat
aDiviyat	yat
samyat	yat
aBisamyat	yat
pratisamyat	yat
upayantray	yantray
upayantr	yantray
niyantray	yantray
niyantr	yantray
samyantray	yantray
samyantr	yantray
prayaB	yaB
aDiyam	yam
anuyam	yam
antaryam	yam
Ayam	yam
apAyam	yam
aByAyam	yam
udAyam	yam
upAyam	yam
nirAyam	yam
paryAyam	yam
vyAyam	yam
samAyam	yam
aBisamAyam	yam
udyam	yam
aByudyam	yam
upodyam	yam
prodyam	yam
pratyudyam	yam
samudyam	yam
upayam	yam
niyam	yam
pratiniyam	yam
viniyam	yam
saMniyam	yam
nisyam	yam
pariyam	yam
prayam	yam
atiprayam	yam
anuprayam	yam
Aprayam	yam
upaprayam	yam
pratiprayam	yam
samprayam	yam
pratiyam	yam
viyam	yam
samyam	yam
aBisamyam	yam
avayas	yas
Ayas	yas
samAyas	yas
udyas	yas
niyas	yas
nisyas	yas
prayas	yas
samprayas	yas
samyas	yas
acCayA	yA
atiyA	yA
vyatiyA	yA
samatiyA	yA
aDiyA	yA
anuyA	yA
antaryA	yA
apayA	yA
aByapayA	yA
vyApayA	yA
pratyapayA	yA
vyapayA	yA
apiyA	yA
aBiyA	yA
pratyaBiyA	yA
samaBiyA	yA
avayA	yA
AyA	yA
atyAyA	yA
anvAyA	yA
aByAyA	yA
udAyA	yA
upAyA	yA
aByupAyA	yA
samupAyA	yA
paryAyA	yA
anuparyAyA	yA
prAyA	yA
pratyAyA	yA
samAyA	yA
aBisamAyA	yA
udyA	yA
aByudyA	yA
pratyudyA	yA
samudyA	yA
upayA	yA
aByupayA	yA
upopayA	yA
pratyupayA	yA
samupayA	yA
niyA	yA
pariRiyA	yA
praRiyA	yA
nisyA	yA
aBinisyA	yA
pratinisyA	yA
vinisyA	yA
parAyA	yA
pariyA	yA
anupariyA	yA
prayA	yA
anuprayA	yA
samanuprayA	yA
aBiprayA	yA
upaprayA	yA
pariprayA	yA
pratiprayA	yA
viprayA	yA
samprayA	yA
anusamprayA	yA
aBisamprayA	yA
upasamprayA	yA
pratiyA	yA
viyA	yA
aBiviyA	yA
samyA	yA
anusamyA	yA
aBisamyA	yA
upasamyA	yA
pratisamyA	yA
anuyAc	yAc
pratyanuyAc	yAc
aBiyAc	yAc
samaBiyAc	yAc
AyAc	yAc
upayAc	yAc
nisyAc	yAc
prayAc	yAc
samprayAc	yAc
vyatiyu	yu
anuyu	yu
aBiyu	yu
Ayu	yu
aByAyu	yu
udAyu	yu
paryAyu	yu
samAyu	yu
udyu	yu
niyu	yu
pariyu	yu
prayu	yu
pratiprayu	yu
pratiyu	yu
viyu	yu
praviyu	yu
samyu	yu
apayu	yu
nisyu	yu
nirAyuC	yuC
prayuC	yuC
aDiyuj	yuj
anuyuj	yuj
aByanuyuj	yuj
samanuyuj	yuj
apayuj	yuj
aBiyuj	yuj
pratyaBiyuj	yuj
Ayuj	yuj
aByAyuj	yuj
upAyuj	yuj
samupAyuj	yuj
vyAyuj	yuj
samAyuj	yuj
aBisamAyuj	yuj
udyuj	yuj
samudyuj	yuj
upayuj	yuj
paryupayuj	yuj
vyupayuj	yuj
samupayuj	yuj
niyuj	yuj
anuniyuj	yuj
upaniyuj	yuj
viniyuj	yuj
saMniyuj	yuj
nisyuj	yuj
prayuj	yuj
atiprayuj	yuj
anuprayuj	yuj
aBiprayuj	yuj
pratiprayuj	yuj
samprayuj	yuj
pratiyuj	yuj
viyuj	yuj
samyuj	yuj
anusamyuj	yuj
aBisamyuj	yuj
upasamyuj	yuj
visamyuj	yuj
anuyuD	yuD
aBiyuD	yuD
AyuD	yuD
prAyuD	yuD
udyuD	yuD
niyuD	yuD
prayuD	yuD
samprayuD	yuD
pratiyuD	yuD
samyuD	yuD
pratisamyuD	yuD
Ayup	yup
nisyez	yez
aDirakz	rakz
anurakz	rakz
aBirakz	rakz
samaBirakz	rakz
avarakz	rakz
Arakz	rakz
uparakz	rakz
pranirakz	rakz
parirakz	rakz
saMparirakz	rakz
prarakz	rakz
pratirakz	rakz
virakz	rakz
saMrakz	rakz
Arac	rac
uparac	rac
samuparac	rac
virac	rac
anuraj	raj
anuraYj	raj
aparaj	raj
aparaYj	raj
aBiraj	raj
aBiraYj	raj
samaBiraj	raj
samaBiraYj	raj
udraj	raj
udraYj	raj
uparaj	raj
uparaYj	raj
pratiraj	raj
pratiraYj	raj
viraj	raj
viraYj	raj
saMraj	raj
saMraYj	raj
anusaMraj	raj
anusaMraYj	raj
aBisaMraj	raj
aBisaMraYj	raj
aBiraYj	raYj
AraYj	raYj
niraYj	raYj
praraYj	raYj
saMraYj	raYj
Araw	raw
pariraw	raw
prarad	rad
virad	rad
uparaD	raD
niraD	raD
pariraD	raD
niran	ran
viran	ran
Arap	rap
parirap	rap
prarap	rap
pratirap	rap
prarapS	rapS
virapS	rapS
aBiraB	raB
AraB	raB
anvAraB	raB
vyanvAraB	raB
samanvAraB	raB
aByAraB	raB
samupAraB	raB
prAraB	raB
vyAraB	raB
samAraB	raB
anusamAraB	raB
upasamAraB	raB
pariraB	raB
saMpariraB	raB
saMraB	raB
anusaMraB	raB
aBisaMraB	raB
pratisaMraB	raB
atiram	ram
anuram	ram
aparam	ram
aBiram	ram
avaram	ram
upAvaram	ram
Aram	ram
upAram	ram
vyupAram	ram
samAram	ram
udram	ram
uparam	ram
vyuparam	ram
niram	ram
pariram	ram
pratiram	ram
viram	ram
praviram	ram
saMram	ram
avaramb	ramb
Aramb	ramb
uparamB	ramB
anuras	ras
aBiras	ras
Aras	ras
niras	ras
pratiras	ras
viras	ras
virah	rah
vyatirA	rA
saMrA	rA
aBirA	rA
atirAj	rAj
anurAj	rAj
aparAj	rAj
aBirAj	rAj
uparAj	rAj
nisrAj	rAj
parirAj	rAj
pratirAj	rAj
virAj	rAj
ativirAj	rAj
aDivirAj	rAj
anuvirAj	rAj
aBivirAj	rAj
saMvirAj	rAj
saMrAj	rAj
anurAD	rAD
aparAD	rAD
aBirAD	rAD
avarAD	rAD
ArAD	rAD
upArAD	rAD
samArAD	rAD
uparAD	rAD
prarAD	rAD
pratirAD	rAD
virAD	rAD
saMrAD	rAD
aBisaMrAD	rAD
parirAs	rAs
anuri	ri
Ari	ri
niri	ri
nisri	ri
prari	ri
viri	ri
saMri	ri
AriK	riK
atiric	ric
atyatiric	ric
aByatiric	ric
vyatiric	ric
anuric	ric
Aric	ric
udric	ric
samudric	ric
niric	ric
praric	ric
viric	ric
apirip	rip
vyapariP	riP
avariP	riP
AriP	riP
viriP	riP
aBiriB	riB
viriB	riB
AriS	riS
viriS	riS
anuriz	riz
Ariz	riz
Arih	rih
paririh	rih
pratirih	rih
saMrih	rih
anuru	ru
aBiru	ru
Aru	ru
uparu	ru
praru	ru
pratiru	ru
viru	ru
saMru	ru
atiruc	ruc
anuruc	ruc
aBiruc	ruc
avaruc	ruc
Aruc	ruc
udruc	ruc
uparuc	ruc
nisruc	ruc
pariruc	ruc
praruc	ruc
sampraruc	ruc
pratiruc	ruc
viruc	ruc
ativiruc	ruc
aBiviruc	ruc
saMruc	ruc
aBiruj	ruj
avaruj	ruj
Aruj	ruj
samAruj	ruj
udruj	ruj
samuparuj	ruj
pariruj	ruj
praruj	ruj
viruj	ruj
saMruj	ruj
anurud	rud
aBirud	rud
avarud	rud
upArud	rud
uparud	rud
nirud	rud
prarud	rud
virud	rud
saMrud	rud
avaruD	ruD
udruD	ruD
praruD	ruD
viruD	ruD
anuruD	ruD
aparuD	ruD
vyaparuD	ruD
aBiruD	ruD
avAvaruD	ruD
paryavaruD	ruD
pratyavaruD	ruD
samavaruD	ruD
AruD	ruD
samAruD	ruD
uparuD	ruD
pratyuparuD	ruD
samuparuD	ruD
niruD	ruD
upaniruD	ruD
saMniruD	ruD
pariruD	ruD
sampraruD	ruD
pratiruD	ruD
prativiruD	ruD
saMruD	ruD
atisaMruD	ruD
aBisaMruD	ruD
upasaMruD	ruD
pratisaMruD	ruD
Arup	rup
aBiruz	ruz
Aruz	ruz
sampraruz	ruz
viruz	ruz
saMruz	ruz
atiruh	ruh
vyatiruh	ruh
aDiruh	ruh
anvaDiruh	ruh
upADiruh	ruh
samaDiruh	ruh
anuruh	ruh
vyaparuh	ruh
apiruh	ruh
samapiruh	ruh
aBiruh	ruh
samaBiruh	ruh
avaruh	ruh
aDyavaruh	ruh
anvavaruh	ruh
aByavaruh	ruh
upAvaruh	ruh
pratyavaruh	ruh
aBipratyavaruh	ruh
vyavaruh	ruh
Aruh	ruh
atyAruh	ruh
aDyAruh	ruh
anvAruh	ruh
upAnvAruh	ruh
samanvAruh	ruh
aByAruh	ruh
avAruh	ruh
udAruh	ruh
upAruh	ruh
samupAruh	ruh
paryAruh	ruh
prAruh	ruh
pratyAruh	ruh
samAruh	ruh
anusamAruh	ruh
aBisamAruh	ruh
uparuh	ruh
niruh	ruh
nisruh	ruh
praruh	ruh
anupraruh	ruh
aBipraruh	ruh
pratiruh	ruh
viruh	ruh
saMruh	ruh
upasaMruh	ruh
virUkzay	rUkzay
virUkz	rUkzay
nirUpay	rUpay
nirUp	rUpay
prarUpay	rUpay
prarUp	rUpay
virUpay	rUpay
virUp	rUpay
saMrUz	rUz
prarej	rej
saMrej	rej
atilakzay	lakzay
atilakz	lakzay
anulakzay	lakzay
anulakz	lakzay
aBilakzay	lakzay
aBilakz	lakzay
Alakzay	lakzay
Alakz	lakzay
upAlakzay	lakzay
upAlakz	lakzay
samAlakzay	lakzay
samAlakz	lakzay
upalakzay	lakzay
upalakz	lakzay
aByupalakzay	lakzay
aByupalakz	lakzay
samupalakzay	lakzay
samupalakz	lakzay
sampratilakzay	lakzay
sampratilakz	lakzay
vilakzay	lakzay
vilakz	lakzay
saMlakzay	lakzay
saMlakz	lakzay
anulag	lag
avalag	lag
Alag	lag
samAlag	lag
parilag	lag
vilag	lag
saMlag	lag
vilaNg	laNg
atilaNG	laNG
aBilaNG	laNG
avalaNG	laNG
AlaNG	laNG
udlaNG	laNG
samudlaNG	laNG
parilaNG	laNG
pratilaNG	laNG
vilaNG	laNG
ativilaNG	laNG
saMvilaNG	laNG
saMlaNG	laNG
aDilajj	lajj
vilajj	lajj
saMlajj	lajj
anulap	lap
apalap	lap
aBilap	lap
Alap	lap
upAlap	lap
samAlap	lap
udlap	lap
samudlap	lap
pralap	lap
vipralap	lap
sampralap	lap
vilap	lap
pravilap	lap
saMlap	lap
anulaB	laB
aBilaB	laB
AlaB	laB
anvAlaB	laB
upAlaB	laB
paryAlaB	laB
pratyAlaB	laB
samAlaB	laB
upalaB	laB
pratyupalaB	laB
samupalaB	laB
parilaB	laB
pralaB	laB
vipralaB	laB
pratilaB	laB
vilaB	laB
pravilaB	laB
saMlaB	laB
avalamb	lamb
vyavalamb	lamb
samavalamb	lamb
Alamb	lamb
aDyAlamb	lamb
apAlamb	lamb
vyAlamb	lamb
samAlamb	lamb
udlamb	lamb
samudlamb	lamb
parilamb	lamb
pralamb	lamb
aBipralamb	lamb
pratilamb	lamb
vilamb	lamb
pravilamb	lamb
anulal	lal
upAlal	lal
udlal	lal
upalal	lal
vilal	lal
saMlal	lal
apalaz	laz
aBilaz	laz
samaBilaz	laz
anulas	las
aBilas	las
udlas	las
atyudlas	las
aByudlas	las
paryudlas	las
pratyudlas	las
prodlas	las
samudlas	las
upalas	las
parilas	las
vilas	las
pravilas	las
AlA	lA
nislAYC	lAYC
apaliK	liK
aBiliK	liK
avaliK	liK
vyavaliK	liK
AliK	liK
vyAliK	liK
samAliK	liK
udliK	liK
prodliK	liK
samudliK	liK
upaliK	liK
nisliK	liK
vinisliK	liK
pariliK	liK
vipariliK	liK
praliK	liK
pratiliK	liK
viliK	liK
saMliK	liK
viliKApay	liKApay
viliK	liKApay
udliNgay	liNgay
udliNg	liNgay
anulip	lip
aBilip	lip
avalip	lip
Alip	lip
samAlip	lip
upalip	lip
paryupalip	lip
nilip	lip
parilip	lip
pralip	lip
vilip	lip
pravilip	lip
saMlip	lip
AliS	liS
viliS	liS
avalih	lih
Alih	lih
pratyAlih	lih
udlih	lih
upalih	lih
nislih	lih
parilih	lih
pralih	lih
pratilih	lih
vilih	lih
saMlih	lih
parisaMlih	lih
anulI	lI
apalI	lI
aBilI	lI
avalI	lI
vyavalI	lI
samavalI	lI
AlI	lI
pratyAlI	lI
upalI	lI
nilI	lI
apanilI	lI
aBinilI	lI
saMnilI	lI
pralI	lI
vipralI	lI
sampralI	lI
pratilI	lI
vilI	lI
anuvilI	lI
aBivilI	lI
pravilI	lI
sampravilI	lI
saMlI	lI
pratisaMlI	lI
avaluYc	luYc
AluYc	luYc
udluYc	luYc
nisluYc	luYc
viluYc	luYc
aDiluW	luW
aBiluW	luW
udluW	luW
nisluW	luW
parinisluW	luW
pariluW	luW
praluW	luW
viluW	luW
avaluq	luq
Aluq	luq
vyAluq	luq
samAluq	luq
nisluq	luq
pariluq	luq
vipraluq	luq
pratiluq	luq
viluq	luq
ativiluq	luq
saMluq	luq
nisluRw	luRw
viluRw	luRw
udluRW	luRW
nisluRW	luRW
viluRW	luRW
apalup	lup
aBilup	lup
avalup	lup
anvavalup	lup
samavalup	lup
Alup	lup
vyAlup	lup
udlup	lup
samudlup	lup
nilup	lup
nislup	lup
parilup	lup
viparilup	lup
pralup	lup
vipralup	lup
sampralup	lup
vilup	lup
pravilup	lup
saMlup	lup
anuluB	luB
aBiluB	luB
avaluB	luB
AluB	luB
upaluB	luB
pariluB	luB
praluB	luB
upapraluB	luB
vipraluB	luB
sampraluB	luB
pratiluB	luB
viluB	luB
saMluB	luB
aBilul	lul
Alul	lul
udlul	lul
vilul	lul
saMlul	lul
vyatilU	lU
aBilU	lU
avalU	lU
AlU	lU
nyAlU	lU
vyAlU	lU
udlU	lU
nislU	lU
parilU	lU
pralU	lU
vipralU	lU
vilU	lU
aBilok	lok
avalok	lok
samavalok	lok
Alok	lok
prAlok	lok
samAlok	lok
udlok	lok
parilok	lok
vilok	lok
pravilok	lok
saMlok	lok
Aloc	loc
anvAloc	loc
avAloc	loc
paryAloc	loc
samAloc	loc
udloc	loc
nisloc	loc
viloc	loc
ativakz	vakz
acCavac	vac
ativac	vac
aDivac	vac
anuvac	vac
aByanuvac	vac
apavac	vac
aBivac	vac
Avac	vac
udvac	vac
upavac	vac
nivac	vac
nisvac	vac
parAvac	vac
parivac	vac
pravac	vac
anupravac	vac
paripravac	vac
pratipravac	vac
sampravac	vac
prativac	vac
vivac	vac
saMvac	vac
acCavaYc	vaYc
anuvaYc	vaYc
aBivaYc	vaYc
AvaYc	vaYc
udvaYc	vaYc
upavaYc	vaYc
nisvaYc	vaYc
parivaYc	vaYc
pravaYc	vaYc
saMvaYc	vaYc
acCavad	vad
ativad	vad
aByativad	vad
aDivad	vad
anuvad	vad
aByanuvad	vad
apavad	vad
aBivad	vad
pratyaBivad	vad
samaBivad	vad
avavad	vad
vyavavad	vad
Avad	vad
samAvad	vad
udvad	vad
pratyudvad	vad
upavad	vad
pratyupavad	vad
nivad	vad
nisvad	vad
aBinisvad	vad
parAvad	vad
aBiparAvad	vad
parivad	vad
pravad	vad
anupravad	vad
aBipravad	vad
upapravad	vad
vipravad	vad
sampravad	vad
prativad	vad
vivad	vad
prativivad	vad
saMvad	vad
upasaMvad	vad
parisaMvad	vad
pratisaMvad	vad
visaMvad	vad
apavaD	vaD
aBivaD	vaD
samaBivaD	vaD
AvaD	vaD
udvaD	vaD
upavaD	vaD
nivaD	vaD
nisvaD	vaD
parAvaD	vaD
pravaD	vaD
prativaD	vaD
vivaD	vaD
apivan	van
aBivan	van
Avan	van
nivan	van
pravan	van
saMvan	van
anuvand	vand
aBivand	vand
parivand	vand
pravand	vand
prativand	vand
saMvand	vand
parivap	vap
pravap	vap
anupravap	vap
vivap	vap
aDivap	vap
anuvap	vap
apavap	vap
apivap	vap
aBivap	vap
Avap	vap
aDyAvap	vap
anvAvap	vap
paryAvap	vap
pratyAvap	vap
vyAvap	vap
samAvap	vap
udvap	vap
upavap	vap
nivap	vap
upanivap	vap
parinivap	vap
saMnivap	vap
nisvap	vap
anunisvap	vap
aBinisvap	vap
parinisvap	vap
pratinisvap	vap
vinisvap	vap
saMnisvap	vap
parAvap	vap
prativap	vap
saMvap	vap
aBivam	vam
Avam	vam
udvam	vam
samudvam	vam
nisvam	vam
vinisvam	vam
parAvam	vam
anuvar	var
anuvf	var
apavar	var
apavf	var
apivar	var
apivf	var
aBivar	var
aBivf	var
Avar	var
Avf	var
apAvar	var
apAvf	var
upAvar	var
upAvf	var
samupAvar	var
samupAvf	var
paryAvar	var
paryAvf	var
prAvar	var
prAvf	var
saMprAvar	var
saMprAvf	var
vyAvar	var
vyAvf	var
samAvar	var
samAvf	var
udvar	var
udvf	var
nivar	var
nivf	var
upanivar	var
upanivf	var
pratinivar	var
pratinivf	var
vinivar	var
vinivf	var
saMnivar	var
saMnivf	var
nisvar	var
nisvf	var
parinisvar	var
parinisvf	var
parivar	var
parivf	var
aBiparivar	var
aBiparivf	var
saMparivar	var
saMparivf	var
pravar	var
pravf	var
prativar	var
prativf	var
vivar	var
vivf	var
saMvar	var
saMvf	var
aBisaMvar	var
aBisaMvf	var
samaBisaMvar	var
samaBisaMvf	var
parisaMvar	var
parisaMvf	var
aDivarj	varj
aDivfj	varj
anuvarj	varj
anuvfj	varj
apavarj	varj
apavfj	varj
vyapavarj	varj
vyapavfj	varj
samapavarj	varj
samapavfj	varj
apivarj	varj
apivfj	varj
aBivarj	varj
aBivfj	varj
avavarj	varj
avavfj	varj
Avarj	varj
Avfj	varj
apAvarj	varj
apAvfj	varj
prAvarj	varj
prAvfj	varj
vyAvarj	varj
vyAvfj	varj
parivyAvarj	varj
parivyAvfj	varj
samAvarj	varj
samAvfj	varj
udvarj	varj
udvfj	varj
nivarj	varj
nivfj	varj
anunivarj	varj
anunivfj	varj
parAvarj	varj
parAvfj	varj
parivarj	varj
parivfj	varj
saMparivarj	varj
saMparivfj	varj
pravarj	varj
pravfj	varj
anupravarj	varj
anupravfj	varj
prativarj	varj
prativfj	varj
vivarj	varj
vivfj	varj
saMvarj	varj
saMvfj	varj
acCavart	vart
acCavft	vart
ativart	vart
ativft	vart
aByativart	vart
aByativft	vart
vyativart	vart
vyativft	vart
samativart	vart
samativft	vart
aDivart	vart
aDivft	vart
anuvart	vart
anuvft	vart
samanuvart	vart
samanuvft	vart
apavart	vart
apavft	vart
vyapavart	vart
vyapavft	vart
samapavart	vart
samapavft	vart
apivart	vart
apivft	vart
aBivart	vart
aBivft	vart
samaBivart	vart
samaBivft	vart
aByavavart	vart
aByavavft	vart
nyavavart	vart
nyavavft	vart
samavavart	vart
samavavft	vart
Avart	vart
Avft	vart
anvatyAvart	vart
anvatyAvft	vart
anvAvart	vart
anvAvft	vart
apAvart	vart
apAvft	vart
aByAvart	vart
aByAvft	vart
udAvart	vart
udAvft	vart
upAvart	vart
upAvft	vart
paryupAvart	vart
paryupAvft	vart
nyAvart	vart
nyAvft	vart
paryAvart	vart
paryAvft	vart
anuparyAvart	vart
anuparyAvft	vart
apaparyAvart	vart
apaparyAvft	vart
aBiparyAvart	vart
aBiparyAvft	vart
upaparyAvart	vart
upaparyAvft	vart
pratiparyAvart	vart
pratiparyAvft	vart
viparyAvart	vart
viparyAvft	vart
prAvart	vart
prAvft	vart
pratyAvart	vart
pratyAvft	vart
vyAvart	vart
vyAvft	vart
samAvart	vart
samAvft	vart
aBisamAvart	vart
aBisamAvft	vart
upasamAvart	vart
upasamAvft	vart
udvart	vart
udvft	vart
samudvart	vart
samudvft	vart
upavart	vart
upavft	vart
samupavart	vart
samupavft	vart
nivart	vart
nivft	vart
anunivart	vart
anunivft	vart
aBinivart	vart
aBinivft	vart
upanivart	vart
upanivft	vart
aByupanivart	vart
aByupanivft	vart
parinivart	vart
parinivft	vart
pratinivart	vart
pratinivft	vart
vinivart	vart
vinivft	vart
samnivart	vart
samnivft	vart
nisvart	vart
nisvft	vart
aBinisvart	vart
aBinisvft	vart
upanisvart	vart
upanisvft	vart
vinisvart	vart
vinisvft	vart
parAvart	vart
parAvft	vart
viparAvart	vart
viparAvft	vart
parivart	vart
parivft	vart
anuparivart	vart
anuparivft	vart
viparivart	vart
viparivft	vart
saMparivart	vart
saMparivft	vart
pravart	vart
pravft	vart
atipravart	vart
atipravft	vart
anupravart	vart
anupravft	vart
aBipravart	vart
aBipravft	vart
upapravart	vart
upapravft	vart
paripravart	vart
paripravft	vart
pratipravart	vart
pratipravft	vart
sampravart	vart
sampravft	vart
aBisampravart	vart
aBisampravft	vart
prativart	vart
prativft	vart
vivart	vart
vivft	vart
ativivart	vart
ativivft	vart
anuvivart	vart
anuvivft	vart
saMvart	vart
saMvft	vart
aDisaMvart	vart
aDisaMvft	vart
aBisaMvart	vart
aBisaMvft	vart
ativarD	varD
aDivarD	varD
anuvarD	varD
aBivarD	varD
samaBivarD	varD
AvarD	varD
udvarD	varD
nivarD	varD
parivarD	varD
pravarD	varD
atipravarD	varD
aBipravarD	varD
pratipravarD	varD
sampravarD	varD
prativarD	varD
vivarD	varD
aBivivarD	varD
pravivarD	varD
saMvivarD	varD
saMvarD	varD
atisaMvarD	varD
aBisaMvarD	varD
ativarz	varz
ativfz	varz
anuvarz	varz
anuvfz	varz
aBivarz	varz
aBivfz	varz
samaBivarz	varz
samaBivfz	varz
avavarz	varz
avavfz	varz
Avarz	varz
Avfz	varz
udvarz	varz
udvfz	varz
nisvarz	varz
nisvfz	varz
parivarz	varz
parivfz	varz
pravarz	varz
pravfz	varz
aBipravarz	varz
aBipravfz	varz
sampravarz	varz
sampravfz	varz
prativarz	varz
prativfz	varz
vivarz	varz
vivfz	varz
saMvarz	varz
saMvfz	varz
atival	val
Aval	val
vival	val
saMval	val
ativalg	valg
aBivalg	valg
Avalg	valg
vyAvalg	valg
parAvalg	valg
pravalg	valg
vivalg	valg
saMvalg	valg
upavalh	valh
pravalh	valh
anuvaS	vaS
aBivaS	vaS
AvaS	vaS
samAvaS	vaS
aDivas	vas
apavas	vas
vivas	vas
aBivivas	vas
parivivas	vas
anuvas	vas
aBivas	vas
upavas	vas
nivas	vas
pratinivas	vas
saMnivas	vas
parivas	vas
pravas	vas
prativas	vas
saMvas	vas
aBisaMvas	vas
samanuvas	vas
antarvas	vas
Avas	vas
aDyAvas	vas
udAvas	vas
upAvas	vas
samAvas	vas
udvas	vas
anUdvas	vas
aByudvas	vas
paryudvas	vas
samudvas	vas
upAvavas	vas
samupavas	vas
aDinivas	vas
nisvas	vas
atipravas	vas
apapravas	vas
vipravas	vas
sampravas	vas
nirvivas	vas
sahavas	vas
aDisaMvas	vas
saMvastray	vastray
saMvastraya	vastray
ativah	vah
samativah	vah
aDivah	vah
anuvah	vah
apavah	vah
pratyapavah	vah
vyapavah	vah
aBivah	vah
Avah	vah
anvAvah	vah
aByAvah	vah
udAvah	vah
samudAvah	vah
upAvah	vah
nirAvah	vah
samAvah	vah
udvah	vah
prodvah	vah
samudvah	vah
upavah	vah
samupavah	vah
nivah	vah
pariRivah	vah
nisvah	vah
pratinisvah	vah
parAvah	vah
parivah	vah
pravah	vah
atipravah	vah
anupravah	vah
aBipravah	vah
sampravah	vah
prativah	vah
vivah	vah
saMvivah	vah
saMvah	vah
anusaMvah	vah
ativA	vA
anuvA	vA
apavA	vA
aBivA	vA
avavA	vA
AvA	vA
udvA	vA
anUdvA	vA
upavA	vA
nisvA	vA
anunisvA	vA
parinisvA	vA
parAvA	vA
pravA	vA
vivA	vA
anuvivA	vA
saMvA	vA
anusaMvA	vA
atipravA	vA
acCavA	vA
aByAvA	vA
samAvA	vA
parivA	vA
anupravA	vA
sampravA	vA
upavAjay	vAjay
upavAjaya	vAjay
aBivAYC	vAYC
samaBivAYC	vAYC
nisvApay	vApay
nisvap	vApay
anuvAS	vAS
pratyanuvAS	vAS
aBivAS	vAS
udvAS	vAS
nivAS	vAS
pravAS	vAS
prativAS	vAS
saMvAS	vAS
aDivAsay	vAsay
aDivAs	vAsay
anuvAsay	vAsay
anuvAs	vAsay
aBivAsay	vAsay
aBivAs	vAsay
AvAsay	vAsay
AvAs	vAsay
samAvAsay	vAsay
samAvAs	vAsay
saMvAsay	vAsay
saMvAs	vAsay
pravAh	vAh
sampravAh	vAh
saMviGnay	viGnay
saMviGnaya	viGnay
apavic	vic
aDyapavic	vic
udvic	vic
pravic	vic
vivic	vic
pravivic	vic
saMvic	vic
aBivij	vij
Avij	vij
samAvij	vij
udvij	vij
paryudvij	vij
prodvij	vij
samudvij	vij
pravij	vij
vivij	vij
saMvij	vij
anuvid	vid
samanuvid	vid
aBivid	vid
vyavavid	vid
Avid	vid
samAvid	vid
upavid	vid
nivid	vid
atinivid	vid
vinivid	vid
saMnivid	vid
nisvid	vid
parivid	vid
pravid	vid
anupravid	vid
pratipravid	vid
prativid	vid
samprativid	vid
vivid	vid
saMvid	vid
anusaMvid	vid
aBisaMvid	vid
pratisaMvid	vid
aDivid	vid
parinisvid	vid
upaviD	viD
prativiD	viD
udvip	vip
parivip	vip
pravip	vip
aBipravip	vip
sampravip	vip
vivip	vip
pravivip	vip
saMvip	vip
punarviS	viS
aDiviS	viS
anuviS	viS
apaviS	viS
aBiviS	viS
AviS	viS
anvAviS	viS
aByAviS	viS
upAviS	viS
samupAviS	viS
nyAviS	viS
nirAviS	viS
prAviS	viS
vyAviS	viS
samAviS	viS
upaviS	viS
aDyupaviS	viS
anUpaviS	viS
aByupaviS	viS
upopaviS	viS
samupopaviS	viS
paryupaviS	viS
pratyupaviS	viS
vyupaviS	viS
samupaviS	viS
niviS	viS
aDiniviS	viS
aBiniviS	viS
prativiS	viS
upaniviS	viS
pariRiviS	viS
praRiviS	viS
pratiniviS	viS
viniviS	viS
saMniviS	viS
aBisaMniviS	viS
nisviS	viS
pariviS	viS
praviS	viS
anupraviS	viS
aBipraviS	viS
pratipraviS	viS
sampraviS	viS
viviS	viS
anuviviS	viS
saMviS	viS
anusaMviS	viS
aBisaMviS	viS
upasaMviS	viS
pratisaMviS	viS
praviSAlay	viSAlay
praviSAlaya	viSAlay
Aviz	viz
upaviz	viz
niviz	viz
nisviz	viz
pariviz	viz
praviviz	viz
saMviz	viz
ativI	vI
aBivI	vI
avavI	vI
AvI	vI
upAvI	vI
nivI	vI
pravI	vI
prativI	vI
apavI	vI
udvI	vI
anuvIj	vIj
AvIj	vIj
upavIj	vIj
parivIj	vIj
saMvIj	vIj
anuvIray	vIray
anuvIr	vIray
AvfzAy	vfzAy
AvfzAya	vfzAy
udvfzAy	vfzAy
udvfzAya	vfzAy
praveD	veD
sampraveD	veD
anuven	ven
apaven	ven
anuvell	vell
udvell	vell
vivell	vell
saMvell	vell
anuvezw	vezw
apavezw	vezw
aBivezw	vezw
Avezw	vezw
samAvezw	vezw
udvezw	vezw
upavezw	vezw
nivezw	vezw
upanivezw	vezw
nisvezw	vezw
parivezw	vezw
saMparivezw	vezw
pravezw	vezw
sampravezw	vezw
prativezw	vezw
vivezw	vezw
saMvezw	vezw
aBisaMvezw	vezw
pratisaMvezw	vezw
udvyac	vyac
parivyaT	vyaT
pravyaT	vyaT
sampravyaT	vyaT
vivyaT	vyaT
saMvyaT	vyaT
ativyaD	vyaD
vyativyaD	vyaD
anuvyaD	vyaD
apavyaD	vyaD
vyapavyaD	vyaD
aBivyaD	vyaD
avavyaD	vyaD
AvyaD	vyaD
upAvyaD	vyaD
vyAvyaD	vyaD
samAvyaD	vyaD
udvyaD	vyaD
upavyaD	vyaD
nivyaD	vyaD
aDinivyaD	vyaD
nisvyaD	vyaD
parAvyaD	vyaD
parivyaD	vyaD
pravyaD	vyaD
atipravyaD	vyaD
anupravyaD	vyaD
prativyaD	vyaD
vivyaD	vyaD
saMvyaD	vyaD
aDivyA	vyA
aDivye	vyA
apavyA	vyA
apavye	vyA
apivyA	vyA
apivye	vyA
aBivyA	vyA
aBivye	vyA
avavyA	vyA
avavye	vyA
AvyA	vyA
Avye	vyA
udvyA	vyA
udvye	vyA
upavyA	vyA
upavye	vyA
nivyA	vyA
nivye	vyA
parivyA	vyA
parivye	vyA
prativyA	vyA
prativye	vyA
saMvyA	vyA
saMvye	vyA
anusaMvyA	vyA
anusaMvye	vyA
aBisaMvyA	vyA
aBisaMvye	vyA
upasaMvyA	vyA
upasaMvye	vyA
ativraj	vraj
vyativraj	vraj
anuvraj	vraj
samanuvraj	vraj
apavraj	vraj
aBivraj	vraj
Avraj	vraj
udAvraj	vraj
pratyudAvraj	vraj
upAvraj	vraj
pratyAvraj	vraj
samAvraj	vraj
udvraj	vraj
pratyudvraj	vraj
upavraj	vraj
pratyupavraj	vraj
nisvraj	vraj
parivraj	vraj
pravraj	vraj
anupravraj	vraj
aBipravraj	vraj
vipravraj	vraj
prativraj	vraj
saMvraj	vraj
anusaMvraj	vraj
upasaMvraj	vraj
nisvraRay	vraRay
nisvraR	vraRay
upavratay	vratay
upavrataya	vratay
apivraSc	vraSc
avavraSc	vraSc
AvraSc	vraSc
nivraSc	vraSc
nisvraSc	vraSc
parivraSc	vraSc
pravraSc	vraSc
vivraSc	vraSc
saMvraSc	vraSc
aBivlI	vlI
nisvlI	vlI
pravlI	vlI
vivlI	vlI
saMvlI	vlI
atiSaMs	SaMs
aDiSaMs	SaMs
anuSaMs	SaMs
aBiSaMs	SaMs
avaSaMs	SaMs
ASaMs	SaMs
udASaMs	SaMs
upASaMs	SaMs
pratyASaMs	SaMs
samASaMs	SaMs
udSaMs	SaMs
nisSaMs	SaMs
parASaMs	SaMs
praSaMs	SaMs
atipraSaMs	SaMs
samatipraSaMs	SaMs
aBipraSaMs	SaMs
pratiSaMs	SaMs
viSaMs	SaMs
aBiviSaMs	SaMs
saMSaMs	SaMs
upasaMSaMs	SaMs
anuSak	Sak
pariSak	Sak
praSak	Sak
sampraSak	Sak
pratiSak	Sak
saMSak	Sak
ASak	Sak
upaSak	Sak
viSakalay	Sakalay
viSakalaya	Sakalay
atiSaNk	SaNk
vyatiSaNk	SaNk
aBiSaNk	SaNk
ASaNk	SaNk
upASaNk	SaNk
upaSaNk	SaNk
pariSaNk	SaNk
pratiSaNk	SaNk
viSaNk	SaNk
aBiviSaNk	SaNk
saMSaNk	SaNk
apaSat	Sat
apaSad	Sat
avaSat	Sat
avaSad	Sat
vyavaSat	Sat
vyavaSad	Sat
ASat	Sat
ASad	Sat
niSat	Sat
niSad	Sat
parASat	Sat
parASad	Sat
praSat	Sat
praSad	Sat
viSat	Sat
viSad	Sat
saMSat	Sat
saMSad	Sat
vyavaSad	Sad
ASad	Sad
pariSad	Sad
praSad	Sad
anuSap	Sap
aBiSap	Sap
avaSap	Sap
pariSap	Sap
pratiSap	Sap
viSap	Sap
saMSap	Sap
atiSabday	Sabday
atiSabd	Sabday
anuSabday	Sabday
anuSabd	Sabday
aBiSabday	Sabday
aBiSabd	Sabday
pariSabday	Sabday
pariSabd	Sabday
viSabday	Sabday
viSabd	Sabday
saMSabday	Sabday
saMSabd	Sabday
anuSam	Sam
aBiSam	Sam
avaSam	Sam
vyavaSam	Sam
samavaSam	Sam
upaSam	Sam
aByupaSam	Sam
vyupaSam	Sam
samupaSam	Sam
niSam	Sam
praRiSam	Sam
pariSam	Sam
praSam	Sam
anupraSam	Sam
sampraSam	Sam
pratiSam	Sam
saMSam	Sam
anuniSam	Sam
samanuniSam	Sam
aBiniSam	Sam
upaniSam	Sam
viniSam	Sam
saMniSam	Sam
vyatiSar	Sar
vyatiSF	Sar
anuSar	Sar
anuSF	Sar
apiSar	Sar
apiSF	Sar
avaSar	Sar
avaSF	Sar
ASar	Sar
ASF	Sar
niSar	Sar
niSF	Sar
nisSar	Sar
nisSF	Sar
parASar	Sar
parASF	Sar
pariSar	Sar
pariSF	Sar
praSar	Sar
praSF	Sar
sampraSar	Sar
sampraSF	Sar
pratiSar	Sar
pratiSF	Sar
viSar	Sar
viSF	Sar
aBiviSar	Sar
aBiviSF	Sar
nirviSar	Sar
nirviSF	Sar
praviSar	Sar
praviSF	Sar
saMSar	Sar
saMSF	Sar
aDiSar	Sar
aDiSF	Sar
udSar	Sar
udSF	Sar
saMpariSar	Sar
saMpariSF	Sar
aBisaMSar	Sar
aBisaMSF	Sar
atiSaravyay	Saravyay
atiSaravyaya	Saravyay
praSarD	SarD
praSfD	SarD
atipraSarD	SarD
atipraSfD	SarD
avaSarD	SarD
avaSfD	SarD
viSarD	SarD
viSfD	SarD
udSal	Sal
prodSal	Sal
samudSal	Sal
udSaS	SaS
apiSas	Sas
ASas	Sas
pariSas	Sas
praSas	Sas
viSas	Sas
avaSA	SA
avaSE	SA
ASA	SA
ASE	SA
niSA	SA
niSE	SA
atiSA	SA
atiSE	SA
nisSA	SA
nisSE	SA
saMSA	SA
saMSE	SA
visaMSA	SA
visaMSE	SA
anuSAs	SAs
aByanuSAs	SAs
samanuSAs	SAs
aBiSAs	SAs
ASAs	SAs
saMprASAs	SAs
samASAs	SAs
udSAs	SAs
niSAs	SAs
praSAs	SAs
sampraSAs	SAs
pratiSAs	SAs
viSAs	SAs
saMSAs	SAs
anuSikz	Sikz
aBiSikz	Sikz
ASikz	Sikz
upaSikz	Sikz
saMSikz	Sikz
pratiSikz	Sikz
viSikz	Sikz
udSiNG	SiNG
upaSiNG	SiNG
ASiYj	SiYj
pariSiYj	SiYj
viSiYj	SiYj
saMSiYj	SiYj
pariSiTilay	SiTilay
pariSiTilaya	SiTilay
ASir	Sir
ASrI	Sir
atiSiz	Siz
apaSiz	Siz
avaSiz	Siz
paryavaSiz	Siz
pratyavaSiz	Siz
samavaSiz	Siz
udSiz	Siz
nisSiz	Siz
pariSiz	Siz
viSiz	Siz
praviSiz	Siz
prativiSiz	Siz
saMSiz	Siz
atiSI	SI
aBiSI	SI
avaSI	SI
upaSI	SI
nisSI	SI
vyatiSI	SI
aDiSI	SI
samaDiSI	SI
anuSI	SI
apaSI	SI
ASI	SI
anvASI	SI
pratyASI	SI
udSI	SI
niSI	SI
pariSI	SI
praSI	SI
pratiSI	SI
viSI	SI
saMSI	SI
atiSIlay	SIlay
atiSIl	SIlay
anuSIlay	SIlay
anuSIl	SIlay
pariSIlay	SIlay
pariSIl	SIlay
saMSIlay	SIlay
saMSIl	SIlay
anuSuc	Suc
samanuSuc	Suc
apaSuc	Suc
aBiSuc	Suc
ASuc	Suc
udSuc	Suc
niSuc	Suc
nisSuc	Suc
pariSuc	Suc
praSuc	Suc
anupraSuc	Suc
pratiSuc	Suc
saMSuc	Suc
pariSuD	SuD
praSuD	SuD
aBipraSuD	SuD
viSuD	SuD
praviSuD	SuD
saMSuD	SuD
parisaMSuD	SuD
praSuB	SuB
atiSuB	SuB
anuSuB	SuB
aBiSuB	SuB
samaBiSuB	SuB
upaSuB	SuB
niSuB	SuB
pariSuB	SuB
pratiSuB	SuB
viSuB	SuB
saMSuB	SuB
anuSuz	Suz
avaSuz	Suz
udSuz	Suz
samudSuz	Suz
upaSuz	Suz
pariSuz	Suz
saMpariSuz	Suz
pratiSuz	Suz
viSuz	Suz
saMSuz	Suz
ASuz	Suz
aBiScut	Scut
avaScut	Scut
anvavaScut	Scut
vyavaScut	Scut
AScut	Scut
niScut	Scut
praScut	Scut
viScut	Scut
apaSnaT	SnaT
aBiSnaT	SnaT
niSnaT	SnaT
pariniSnaT	SnaT
aBiSyA	SyA
aBiSyE	SyA
samaBiSyA	SyA
samaBiSyE	SyA
avaSyA	SyA
avaSyE	SyA
ASyA	SyA
ASyE	SyA
praSyA	SyA
praSyE	SyA
pratiSyA	SyA
pratiSyE	SyA
saMSyA	SyA
saMSyE	SyA
aBisaMSyA	SyA
aBisaMSyE	SyA
avasaMSyA	SyA
avasaMSyE	SyA
anuSraT	SraT
niSraT	SraT
praSraT	SraT
viSraT	SraT
udSraTAy	SraTAy
udSraTAya	SraTAy
viSraTAy	SraTAy
viSraTAya	SraTAy
aBiSram	Sram
ASram	Sram
upaSram	Sram
niSram	Sram
pariSram	Sram
saMpariSram	Sram
pratiSram	Sram
viSram	Sram
pariviSram	Sram
saMSram	Sram
niSramB	SramB
praSramB	SramB
viSramB	SramB
ativiSramB	SramB
upaviSramB	SramB
prativiSramB	SramB
ASravasy	Sravasy
ASravasya	Sravasy
aDiSrA	SrA
ASrA	SrA
niSrA	SrA
praSrA	SrA
aDiSri	Sri
pratyaDiSri	Sri
samaDiSri	Sri
anuSri	Sri
apaSri	Sri
aByapaSri	Sri
aBiSri	Sri
avaSri	Sri
upAvaSri	Sri
ASri	Sri
anvASri	Sri
apASri	Sri
vyapASri	Sri
saMvyapASri	Sri
upASri	Sri
samupASri	Sri
pratyASri	Sri
vyASri	Sri
samASri	Sri
pratisamASri	Sri
udSri	Sri
aByudSri	Sri
prodSri	Sri
pratyudSri	Sri
samudSri	Sri
upaSri	Sri
niSri	Sri
aBiniSri	Sri
upaniSri	Sri
upanisSri	Sri
vinisSri	Sri
parASri	Sri
pariSri	Sri
saMpariSri	Sri
praSri	Sri
atipraSri	Sri
upapraSri	Sri
sampraSri	Sri
pratiSri	Sri
viSri	Sri
saMSri	Sri
aBisaMSri	Sri
upasaMSri	Sri
pratisaMSri	Sri
aBiSriz	Sriz
ASriz	Sriz
saMSriz	Sriz
aBiSrI	SrI
saMSrI	SrI
atiSru	Sru
anuSru	Sru
aBiSru	Sru
ASru	Sru
aByASru	Sru
pratyASru	Sru
samASru	Sru
upaSru	Sru
samupaSru	Sru
pariSru	Sru
praSru	Sru
atipraSru	Sru
pratiSru	Sru
sampratiSru	Sru
viSru	Sru
aBiviSru	Sru
saMSru	Sru
aBisaMSru	Sru
pratisaMSru	Sru
ASruz	Sruz
ASru	Sruz
saMSlakzRay	SlakzRay
saMSlakzRaya	SlakzRay
ASlaT	SlaT
viSlaT	SlaT
upaSlAG	SlAG
saMSlAG	SlAG
ASliz	Sliz
upASliz	Sliz
samASliz	Sliz
upaSliz	Sliz
niSliz	Sliz
viSliz	Sliz
praviSliz	Sliz
saMSliz	Sliz
aBisaMSliz	Sliz
upasaMSliz	Sliz
upaSlokay	Slokay
upaSlokaya	Slokay
saMSlokay	Slokay
saMSlokaya	Slokay
udSvaYc	SvaYc
anuSvas	Svas
apaSvas	Svas
aBiSvas	Svas
avaSvas	Svas
ASvas	Svas
paryASvas	Svas
prASvas	Svas
pratyASvas	Svas
samASvas	Svas
udSvas	Svas
prodSvas	Svas
samudSvas	Svas
upaSvas	Svas
niSvas	Svas
viniSvas	Svas
nisSvas	Svas
atinisSvas	Svas
vinisSvas	Svas
parASvas	Svas
praSvas	Svas
aBipraSvas	Svas
viSvas	Svas
ativiSvas	Svas
aBiviSvas	Svas
pariviSvas	Svas
udSvA	SvA
udSvi	SvA
praSvA	SvA
praSvi	SvA
viSvA	SvA
viSvi	SvA
saMSvA	SvA
saMSvi	SvA
avaSvit	Svit
viSvit	Svit
aBizWiv	zWiv
avazWiv	zWiv
nizWiv	zWiv
apanizWiv	zWiv
aBinizWiv	zWiv
avanizWiv	zWiv
vinizWiv	zWiv
niszWiv	zWiv
prazWiv	zWiv
pratizWiv	zWiv
niszWu	zWu
niszWIv	zWu
parizvazk	zvazk
anusac	sac
apasac	sac
aBisac	sac
Asac	sac
upasac	sac
nisac	sac
prasac	sac
pratisac	sac
visac	sac
saMsac	sac
atisaYj	saYj
vyatisaYj	saYj
anusaYj	saYj
aBisaYj	saYj
avasaYj	saYj
AsaYj	saYj
aDyAsaYj	saYj
aByAsaYj	saYj
upAsaYj	saYj
nirAsaYj	saYj
pratyAsaYj	saYj
vyAsaYj	saYj
samAsaYj	saYj
utsaYj	saYj
upasaYj	saYj
nisaYj	saYj
parisaYj	saYj
prasaYj	saYj
anuprasaYj	saYj
samprasaYj	saYj
pratisaYj	saYj
visaYj	saYj
aDivisaYj	saYj
aBivisaYj	saYj
saMsaYj	saYj
atisad	sad
aDisad	sad
anusad	sad
aBisad	sad
avasad	sad
pratyavasad	sad
vyavasad	sad
samavasad	sad
Asad	sad
atyAsad	sad
aDyAsad	sad
aByAsad	sad
upAsad	sad
nyAsad	sad
pratyAsad	sad
samAsad	sad
utsad	sad
aByutsad	sad
upotsad	sad
protsad	sad
pratyutsad	sad
vyutsad	sad
samutsad	sad
upasad	sad
anUpasad	sad
aByupasad	sad
pratyupasad	sad
samupasad	sad
nisad	sad
aDinisad	sad
aBinisad	sad
upanisad	sad
parinisad	sad
vinisad	sad
saMnisad	sad
parisad	sad
prasad	sad
atiprasad	sad
anuprasad	sad
aBiprasad	sad
upaprasad	sad
viprasad	sad
samprasad	sad
pratisad	sad
visad	sad
anuvisad	sad
pravisad	sad
saMsad	sad
aBisan	san
Asan	san
prasan	san
saMsan	san
atisaMDay	saMDay
atisaMDaya	saMDay
pratisaMDay	saMDay
pratisaMDaya	saMDay
aBisap	sap
visapary	sapary
visaparya	sapary
aDisaBAjay	saBAjay
aDisaBAj	saBAjay
acCasar	sar
acCasf	sar
atisar	sar
atisf	sar
anusar	sar
anusf	sar
atyanusar	sar
atyanusf	sar
aByanusar	sar
aByanusf	sar
vyanusar	sar
vyanusf	sar
apasar	sar
apasf	sar
vyapasar	sar
vyapasf	sar
apisar	sar
apisf	sar
aBisar	sar
aBisf	sar
atyaBisar	sar
atyaBisf	sar
avasar	sar
avasf	sar
aByavasar	sar
aByavasf	sar
samavasar	sar
samavasf	sar
Asar	sar
Asf	sar
atyAsar	sar
atyAsf	sar
apAsar	sar
apAsf	sar
pratyAsar	sar
pratyAsf	sar
vyAsar	sar
vyAsf	sar
utsar	sar
utsf	sar
anUtsar	sar
anUtsf	sar
protsar	sar
protsf	sar
pratyutsar	sar
pratyutsf	sar
samutsar	sar
samutsf	sar
upasar	sar
upasf	sar
aByupasar	sar
aByupasf	sar
pratyupasar	sar
pratyupasf	sar
samupasar	sar
samupasf	sar
nisar	sar
nisf	sar
vinisar	sar
vinisf	sar
aBinissar	sar
aBinissf	sar
samaBinissar	sar
samaBinissf	sar
vinissar	sar
vinissf	sar
anuvinissar	sar
anuvinissf	sar
parAsar	sar
parAsf	sar
upaparAsar	sar
upaparAsf	sar
parisar	sar
parisf	sar
prasar	sar
prasf	sar
atiprasar	sar
atiprasf	sar
anuprasar	sar
anuprasf	sar
aBiprasar	sar
aBiprasf	sar
upaprasar	sar
upaprasf	sar
pratiprasar	sar
pratiprasf	sar
viprasar	sar
viprasf	sar
samprasar	sar
samprasf	sar
pratisar	sar
pratisf	sar
vipratisar	sar
vipratisf	sar
visar	sar
visf	sar
anuvisar	sar
anuvisf	sar
pravisar	sar
pravisf	sar
saMsar	sar
saMsf	sar
anusaMsar	sar
anusaMsf	sar
aBisaMsar	sar
aBisaMsf	sar
upasaMsar	sar
upasaMsf	sar
utsarj	sarj
aByutsarj	sarj
atisarj	sarj
atisfj	sarj
aByatisarj	sarj
aByatisfj	sarj
samatisarj	sarj
samatisfj	sarj
anusarj	sarj
anusfj	sarj
aByanusarj	sarj
aByanusfj	sarj
apasarj	sarj
apasfj	sarj
vyapasarj	sarj
vyapasfj	sarj
apisarj	sarj
apisfj	sarj
pratyapisarj	sarj
pratyapisfj	sarj
aBisarj	sarj
aBisfj	sarj
avasarj	sarj
avasfj	sarj
atyavasarj	sarj
atyavasfj	sarj
anvavasarj	sarj
anvavasfj	sarj
aByavasarj	sarj
aByavasfj	sarj
upAvasarj	sarj
upAvasfj	sarj
nyavasarj	sarj
nyavasfj	sarj
pratyavasarj	sarj
pratyavasfj	sarj
vyavasarj	sarj
vyavasfj	sarj
samavasarj	sarj
samavasfj	sarj
Asarj	sarj
Asfj	sarj
aDyAsarj	sarj
aDyAsfj	sarj
upAsarj	sarj
upAsfj	sarj
samAsarj	sarj
samAsfj	sarj
utsarj	sarj
utsfj	sarj
anUtsarj	sarj
anUtsfj	sarj
aByutsarj	sarj
aByutsfj	sarj
paryutsarj	sarj
paryutsfj	sarj
vyutsarj	sarj
vyutsfj	sarj
samutsarj	sarj
samutsfj	sarj
upasarj	sarj
upasfj	sarj
nirupasarj	sarj
nirupasfj	sarj
samupasarj	sarj
samupasfj	sarj
nisarj	sarj
nisfj	sarj
pratinisarj	sarj
pratinisfj	sarj
saMnisarj	sarj
saMnisfj	sarj
nissarj	sarj
nissfj	sarj
aBinissarj	sarj
aBinissfj	sarj
pratinissarj	sarj
pratinissfj	sarj
parAsarj	sarj
parAsfj	sarj
parisarj	sarj
parisfj	sarj
prasarj	sarj
prasfj	sarj
anuprasarj	sarj
anuprasfj	sarj
pariprasarj	sarj
pariprasfj	sarj
pratiprasarj	sarj
pratiprasfj	sarj
visarj	sarj
visfj	sarj
anuvisarj	sarj
anuvisfj	sarj
aBivisarj	sarj
aBivisfj	sarj
udvisarj	sarj
udvisfj	sarj
prativisarj	sarj
prativisfj	sarj
saMvisarj	sarj
saMvisfj	sarj
saMsarj	sarj
saMsfj	sarj
anusaMsarj	sarj
anusaMsfj	sarj
upasaMsarj	sarj
upasaMsfj	sarj
parisaMsarj	sarj
parisaMsfj	sarj
pratisaMsarj	sarj
pratisaMsfj	sarj
atisarp	sarp
atisfp	sarp
vyatisarp	sarp
vyatisfp	sarp
aDisarp	sarp
aDisfp	sarp
samaDisarp	sarp
samaDisfp	sarp
anusarp	sarp
anusfp	sarp
samanusarp	sarp
samanusfp	sarp
apasarp	sarp
apasfp	sarp
pratyapasarp	sarp
pratyapasfp	sarp
vyapasarp	sarp
vyapasfp	sarp
aBisarp	sarp
aBisfp	sarp
avasarp	sarp
avasfp	sarp
anvavasarp	sarp
anvavasfp	sarp
upAvasarp	sarp
upAvasfp	sarp
paryavasarp	sarp
paryavasfp	sarp
pratyavasarp	sarp
pratyavasfp	sarp
vyavasarp	sarp
vyavasfp	sarp
Asarp	sarp
Asfp	sarp
udAsarp	sarp
udAsfp	sarp
upodAsarp	sarp
upodAsfp	sarp
samAsarp	sarp
samAsfp	sarp
utsarp	sarp
utsfp	sarp
protsarp	sarp
protsfp	sarp
samutsarp	sarp
samutsfp	sarp
upasarp	sarp
upasfp	sarp
samupasarp	sarp
samupasfp	sarp
vinisarp	sarp
vinisfp	sarp
nissarp	sarp
nissfp	sarp
aBinissarp	sarp
aBinissfp	sarp
vinissarp	sarp
vinissfp	sarp
parisarp	sarp
parisfp	sarp
prasarp	sarp
prasfp	sarp
anuprasarp	sarp
anuprasfp	sarp
aBiprasarp	sarp
aBiprasfp	sarp
pratiprasarp	sarp
pratiprasfp	sarp
viprasarp	sarp
viprasfp	sarp
samprasarp	sarp
samprasfp	sarp
visarp	sarp
visfp	sarp
anuvisarp	sarp
anuvisfp	sarp
saMsarp	sarp
saMsfp	sarp
anusaMsarp	sarp
anusaMsfp	sarp
upasaMsarp	sarp
upasaMsfp	sarp
visaMsarp	sarp
visaMsfp	sarp
visas	sas
aBisah	sah
utsah	sah
aByutsah	sah
protsah	sah
nisah	sah
nissah	sah
parisah	sah
prasah	sah
aBiprasah	sah
samprasah	sah
pratisah	sah
visah	sah
saMsah	sah
aBisA	sA
aBiso	sA
avasA	sA
avaso	sA
aDyavasA	sA
aDyavaso	sA
anvavasA	sA
anvavaso	sA
udavasA	sA
udavaso	sA
aByudavasA	sA
aByudavaso	sA
upAvasA	sA
upAvaso	sA
niravasA	sA
niravaso	sA
prAvasA	sA
prAvaso	sA
pratyavasA	sA
pratyavaso	sA
vyavasA	sA
vyavaso	sA
anuvyavasA	sA
anuvyavaso	sA
saMvyavasA	sA
saMvyavaso	sA
samavasA	sA
samavaso	sA
nisA	sA
niso	sA
pariRisA	sA
pariRiso	sA
praRisA	sA
praRiso	sA
parisA	sA
pariso	sA
prasA	sA
praso	sA
visA	sA
viso	sA
saMsA	sA
saMso	sA
anusAD	sAD
upasAD	sAD
parisAD	sAD
prasAD	sAD
samprasAD	sAD
saMsAD	sAD
aBisAntvay	sAntvay
aBisAntv	sAntvay
atisi	si
Asi	si
utsi	si
prasi	si
anvatisic	sic
vyatisic	sic
aDisic	sic
anusic	sic
apasic	sic
aBisic	sic
anvaBisic	sic
apABisic	sic
samaBisic	sic
avasic	sic
Asic	sic
anvAsic	sic
aByAsic	sic
avAsic	sic
aBiparyAsic	sic
pratyAsic	sic
vyAsic	sic
samAsic	sic
aBisamAsic	sic
utsic	sic
aByutsic	sic
protsic	sic
vyutsic	sic
samutsic	sic
upasic	sic
nisic	sic
parinisic	sic
saMnisic	sic
nissic	sic
parAsic	sic
parisic	sic
anuparisic	sic
prasic	sic
samprasic	sic
pratisic	sic
visic	sic
anuvisic	sic
saMsic	sic
anusiD	siD
apasiD	siD
aBisiD	siD
avasiD	siD
AsiD	siD
vyAsiD	siD
utsiD	siD
samutsiD	siD
upasiD	siD
nisiD	siD
nissiD	siD
parAsiD	siD
parisiD	siD
prasiD	siD
pratisiD	siD
vipratisiD	siD
sampratisiD	siD
visiD	siD
samprasiD	siD
saMsiD	siD
vyatisiv	siv
anusiv	siv
aBisiv	siv
Asiv	siv
utsiv	siv
nisiv	siv
parisiv	siv
prasiv	siv
pratisiv	siv
visiv	siv
saMsiv	siv
aDisu	su
aBisu	su
atyaBisu	su
Asu	su
utsu	su
nissu	su
parisu	su
prasu	su
visu	su
saMsu	su
aBisaMsu	su
anusU	sU
apasU	sU
aBisU	sU
AsU	sU
utsU	sU
nisU	sU
nissU	sU
parAsU	sU
parisU	sU
aDiprasU	sU
aBiprasU	sU
pratiprasU	sU
visU	sU
prasU	sU
anuprasU	sU
saMsU	sU
aBisUcay	sUcay
aBisUc	sUcay
AsUtray	sUtray
AsUtr	sUtray
samAsUtray	sUtray
samAsUtr	sUtray
visUtray	sUtray
visUtr	sUtray
aBisUd	sUd
nisUd	sUd
vinisUd	sUd
prasUd	sUd
atisev	sev
vyatisev	sev
anusev	sev
aBisev	sev
Asev	sev
pratyAsev	sev
samAsev	sev
upasev	sev
aByupasev	sev
samupasev	sev
nisev	sev
upanisev	sev
parinisev	sev
saMnisev	sev
parisev	sev
pratisev	sev
visev	sev
saMsev	sev
atiskad	skad
atiskand	skad
aDiskad	skad
aDiskand	skad
anuskad	skad
anuskand	skad
aBiskad	skad
aBiskand	skad
pratyaBiskad	skad
pratyaBiskand	skad
avaskad	skad
avaskand	skad
aByavaskad	skad
aByavaskand	skad
paryavaskad	skad
paryavaskand	skad
pratyavaskad	skad
pratyavaskand	skad
samavaskad	skad
samavaskand	skad
Askad	skad
Askand	skad
samAskad	skad
samAskand	skad
utskad	skad
utskand	skad
upaskad	skad
upaskand	skad
pariskad	skad
pariskand	skad
praskad	skad
praskand	skad
aBipraskad	skad
aBipraskand	skad
viskad	skad
viskand	skad
saMskad	skad
saMskand	skad
apaskaB	skaB
AskaB	skaB
upaskaB	skaB
niskaB	skaB
pratiskaB	skaB
aBiskaBAy	skaBAy
aBiskaB	skaBAy
viskaBAy	skaBAy
viskaB	skaBAy
avasku	sku
Asku	sku
nisku	sku
pratisku	sku
praskund	skund
viskuB	skuB
viskumB	skuB
apasKal	sKal
parisKal	sKal
prasKal	sKal
pratisKal	sKal
visKal	sKal
saMsKal	sKal
aBizwan	stan
nisstan	stan
aBinisstan	stan
parinisstan	stan
vinisstan	stan
prastan	stan
vizwan	stan
anustaB	staB
apastaB	staB
aBizwaB	staB
avastaB	staB
paryavastaB	staB
samavastaB	staB
utstaB	staB
pratyutstaB	staB
upastaB	staB
samupastaB	staB
nizwaB	staB
parAstaB	staB
parizwaB	staB
prastaB	staB
pratizwaB	staB
vizwaB	staB
anuvizwaB	staB
saMstaB	staB
aBisaMstaB	staB
parisaMstaB	staB
pratisaMstaB	staB
upastaBAy	staBAy
upastaB	staBAy
vizwaBAy	staBAy
vizwaB	staBAy
anustar	star
anustf	star
aBizwar	star
aBizwf	star
avastar	star
avastf	star
samavastar	star
samavastf	star
Astar	star
Astf	star
upAstar	star
upAstf	star
prAstar	star
prAstf	star
pratyAstar	star
pratyAstf	star
samAstar	star
samAstf	star
upastar	star
upastf	star
nizwar	star
nizwf	star
nisstar	star
nisstf	star
parizwar	star
parizwf	star
prastar	star
prastf	star
anuprastar	star
anuprastf	star
aBiprastar	star
aBiprastf	star
upaprastar	star
upaprastf	star
vizwar	star
vizwf	star
ativizwar	star
ativizwf	star
anuvizwar	star
anuvizwf	star
avizwar	star
avizwf	star
pravizwar	star
pravizwf	star
saMstar	star
saMstf	star
aBisaMstar	star
aBisaMstf	star
parisaMstar	star
parisaMstf	star
atizwiG	stiG
prastiG	stiG
atizwu	stu
anustu	stu
aBizwu	stu
samaBizwu	stu
Astu	stu
upastu	stu
nizwu	stu
parizwu	stu
prastu	stu
aBiprastu	stu
samprastu	stu
pratizwu	stu
vizwu	stu
saMstu	stu
aBisaMstu	stu
parisaMstu	stu
anustuB	stuB
aBizwuB	stuB
vyavastuB	stuB
AstuB	stuB
nizwuB	stuB
parizwuB	stuB
prastuB	stuB
pratizwuB	stuB
vizwuB	stuB
saMstuB	stuB
nizwyA	styA
nizwyE	styA
prastyA	styA
prastyE	styA
saMstyA	styA
saMstyE	styA
atisTA	sTA
vyatisTA	sTA
aDisTA	sTA
samaDisTA	sTA
anusTA	sTA
samanusTA	sTA
apasTA	sTA
apisTA	sTA
aBisTA	sTA
samaBisTA	sTA
avasTA	sTA
anvavasTA	sTA
aByavasTA	sTA
paryavasTA	sTA
pratyavasTA	sTA
vyavasTA	sTA
samavasTA	sTA
AsTA	sTA
anvAsTA	sTA
udAsTA	sTA
upAsTA	sTA
samupAsTA	sTA
prAsTA	sTA
pratyAsTA	sTA
vyAsTA	sTA
anuvyAsTA	sTA
samAsTA	sTA
utTA	sTA
aDyutTA	sTA
anUtsTA	sTA
aByutTA	sTA
samaByutTA	sTA
upotsTA	sTA
paryutTA	sTA
protsTA	sTA
pratyutTA	sTA
vyutTA	sTA
samutTA	sTA
upasTA	sTA
anUpasTA	sTA
aByupasTA	sTA
paryupasTA	sTA
pratyupasTA	sTA
samupasTA	sTA
nisTA	sTA
parinisTA	sTA
nissTA	sTA
parinissTA	sTA
parisTA	sTA
prasTA	sTA
atiprasTA	sTA
anuprasTA	sTA
aBiprasTA	sTA
pratiprasTA	sTA
viprasTA	sTA
samprasTA	sTA
pratisTA	sTA
anupratisTA	sTA
aBipratisTA	sTA
sampratisTA	sTA
visTA	sTA
anuvisTA	sTA
aBivisTA	sTA
upavisTA	sTA
saMsTA	sTA
anusaMsTA	sTA
aBisaMsTA	sTA
upasaMsTA	sTA
parisaMsTA	sTA
pratisaMsTA	sTA
visaMsTA	sTA
apasnA	snA
aBisnA	snA
AsnA	snA
utsnA	snA
nisnA	snA
prasnA	snA
pratisnA	snA
visnA	snA
saMsnA	snA
aBisnih	snih
upasnih	snih
saMsnih	snih
prasnu	snu
avaprasnu	snu
vyatiprasnu	snu
Aspand	spand
upaspand	spand
nispand	spand
aBinispand	spand
parispand	spand
praspand	spand
vispand	spand
saMspand	spand
apaspar	spar
apaspf	spar
avaspar	spar
avaspf	spar
Aspar	spar
Aspf	spar
nisspar	spar
nisspf	spar
vispar	spar
vispf	spar
aDisparD	sparD
parisparD	sparD
prasparD	sparD
pratisparD	sparD
visparD	sparD
saMsparD	sparD
aDisparS	sparS
aDispfS	sparS
anusparS	sparS
anuspfS	sparS
apasparS	sparS
apaspfS	sparS
aBisparS	sparS
aBispfS	sparS
AsparS	sparS
AspfS	sparS
utsparS	sparS
utspfS	sparS
upasparS	sparS
upaspfS	sparS
pratyupasparS	sparS
pratyupaspfS	sparS
samupasparS	sparS
samupaspfS	sparS
nisparS	sparS
nispfS	sparS
parisparS	sparS
parispfS	sparS
saMsparS	sparS
saMspfS	sparS
anusaMsparS	sparS
anusaMspfS	sparS
aBisaMsparS	sparS
aBisaMspfS	sparS
parisaMsparS	sparS
parisaMspfS	sparS
anuspaS	spaS
pratispaS	spaS
vispaS	spaS
saMspaS	spaS
praspUrD	spUrD
praspfD	spUrD
saMspfhay	spfhay
saMspfh	spfhay
nissPar	sPar
parisPar	sPar
visPar	sPar
AsPal	sPal
visPal	sPal
saMsPal	sPal
AsPAy	sPAy
parisPAy	sPAy
visPAy	sPAy
saMsPAy	sPAy
AsPuw	sPuw
parisPuw	sPuw
prasPuw	sPuw
visPuw	sPuw
saMsPuw	sPuw
anusPur	sPur
apasPur	sPur
vyapasPur	sPur
avasPur	sPur
nisPur	sPur
nissPur	sPur
parisPur	sPur
prasPur	sPur
pratisPur	sPur
visPur	sPur
saMsPur	sPur
aBisPUrj	sPUrj
avasPUrj	sPUrj
visPUrj	sPUrj
anusmar	smar
anusmf	smar
pratyanusmar	smar
pratyanusmf	smar
samanusmar	smar
samanusmf	smar
apasmar	smar
apasmf	smar
upasmar	smar
upasmf	smar
nismar	smar
nismf	smar
vinismar	smar
vinismf	smar
prasmar	smar
prasmf	smar
pratismar	smar
pratismf	smar
vismar	smar
vismf	smar
saMsmar	smar
saMsmf	smar
anusaMsmar	smar
anusaMsmf	smar
aBisaMsmar	smar
aBisaMsmf	smar
aBismi	smi
avasmi	smi
utsmi	smi
aByutsmi	smi
upasmi	smi
parismi	smi
prasmi	smi
vismi	smi
anuvismi	smi
saMsmi	smi
acCasyad	syad
acCasyand	syad
atisyad	syad
atisyand	syad
anusyad	syad
anusyand	syad
aBisyad	syad
aBisyand	syad
samaBisyad	syad
samaBisyand	syad
avasyad	syad
avasyand	syad
aByavasyad	syad
aByavasyand	syad
Asyad	syad
Asyand	syad
upAsyad	syad
upAsyand	syad
upasyad	syad
upasyand	syad
nisyad	syad
nisyand	syad
aBinisyad	syad
aBinisyand	syad
nissyad	syad
nissyand	syad
parisyad	syad
parisyand	syad
prasyad	syad
prasyand	syad
pariprasyad	syad
pariprasyand	syad
visyad	syad
visyand	syad
anuvisyad	syad
anuvisyand	syad
aBivisyad	syad
aBivisyand	syad
saMsyad	syad
saMsyand	syad
anusaMsyad	syad
anusaMsyand	syad
atisraMs	sraMs
avasraMs	sraMs
vyavasraMs	sraMs
AsraMs	sraMs
utsraMs	sraMs
parisraMs	sraMs
prasraMs	sraMs
visraMs	sraMs
anuvisraMs	sraMs
prasrA	srA
prasrE	srA
atisru	sru
samatisru	sru
aDisru	sru
aBisru	sru
avasru	sru
anvavasru	sru
vyavasru	sru
samavasru	sru
Asru	sru
upasru	sru
nisru	sru
vinisru	sru
nissru	sru
anuparAsru	sru
parisru	sru
anuparisru	sru
prasru	sru
aBiprasru	sru
avaprasru	sru
samprasru	sru
visru	sru
saMsru	sru
aBisaMsru	sru
aBisvaj	svaj
nisvaj	svaj
parisvaj	svaj
aBiparisvaj	svaj
saMparisvaj	svaj
visvaj	svaj
saMsvaj	svaj
Asvad	svad
samAsvad	svad
pratisvad	svad
saMsvad	svad
aDisvan	svan
anusvan	svan
avasvan	svan
Asvan	svan
nisvan	svan
nissvan	svan
parisvan	svan
prasvan	svan
pratisvan	svan
visvan	svan
anusvap	svap
avasvap	svap
dussvap	svap
nisvap	svap
nissvap	svap
prasvap	svap
aBiprasvap	svap
samprasvap	svap
pratisvap	svap
visvap	svap
saMsvap	svap
atisvar	svar
atisvf	svar
anusvar	svar
anusvf	svar
samanusvar	svar
samanusvf	svar
aBisvar	svar
aBisvf	svar
avasvar	svar
avasvf	svar
upasvar	svar
upasvf	svar
nisvar	svar
nisvf	svar
nissvar	svar
nissvf	svar
parisvar	svar
parisvf	svar
prasvar	svar
prasvf	svar
pratisvar	svar
pratisvf	svar
saMsvar	svar
saMsvf	svar
aBisaMsvar	svar
aBisaMsvf	svar
pratyAsvar	svar
pratyAsvf	svar
Asvid	svid
utsvid	svid
upasvid	svid
parisvid	svid
prasvid	svid
saMsvid	svid
upahad	had
atihan	han
vyatihan	han
anuhan	han
antarhan	han
apahan	han
vyapahan	han
apihan	han
aBihan	han
samaBihan	han
avahan	han
aDyavahan	han
anvavahan	han
aByavahan	han
pratyavahan	han
Ahan	han
apAhan	han
aByAhan	han
udAhan	han
upAhan	han
nirAhan	han
pratyAhan	han
vyAhan	han
samAhan	han
udhan	han
upodhan	han
samudhan	han
upahan	han
samupahan	han
nihan	han
aBinihan	han
upanihan	han
pariRihan	han
praRihan	han
pratinihan	han
vinihan	han
saMnihan	han
nirhan	han
atinirhan	han
aDinirhan	han
parinirhan	han
vinirhan	han
parAhan	han
parihan	han
aBiparihan	han
prahan	han
aBiprahan	han
niprahan	han
nizprahan	han
viprahan	han
pratihan	han
sampratihan	han
vihan	han
anuvihan	han
Avihan	han
pravihan	han
prativihan	han
samhan	han
aBisamhan	han
pratisamhan	han
visamhan	han
atihar	har
atihf	har
aByatihar	har
aByatihf	har
pratyatihar	har
pratyatihf	har
vyatihar	har
vyatihf	har
aDihar	har
aDihf	har
anuhar	har
anuhf	har
vyapahar	har
vyapahf	har
aBihar	har
aBihf	har
pratyaBihar	har
pratyaBihf	har
avahar	har
avahf	har
anvavahar	har
anvavahf	har
aByavahar	har
aByavahf	har
upAvahar	har
upAvahf	har
aByupAvahar	har
aByupAvahf	har
pratyavahar	har
pratyavahf	har
vyavahar	har
vyavahf	har
saMvyavahar	har
saMvyavahf	har
samavahar	har
samavahf	har
Ahar	har
Ahf	har
atyAhar	har
atyAhf	har
aDyAhar	har
aDyAhf	har
anvAhar	har
anvAhf	har
samanvAhar	har
samanvAhf	har
apyAhar	har
apyAhf	har
aByAhar	har
aByAhf	har
udAhar	har
udAhf	har
anUdAhar	har
anUdAhf	har
aByudAhar	har
aByudAhf	har
upodAhar	har
upodAhf	har
pratyudAhar	har
pratyudAhf	har
samudAhar	har
samudAhf	har
upAhar	har
upAhf	har
aByupAhar	har
aByupAhf	har
pratyupAhar	har
pratyupAhf	har
samupAhar	har
samupAhf	har
upanyAhar	har
upanyAhf	har
paryAhar	har
paryAhf	har
pratiparyAhar	har
pratiparyAhf	har
pratyAhar	har
pratyAhf	har
vyAhar	har
vyAhf	har
ativyAhar	har
ativyAhf	har
anuvyAhar	har
anuvyAhf	har
apavyAhar	har
apavyAhf	har
aBivyAhar	har
aBivyAhf	har
samaBivyAhar	har
samaBivyAhf	har
anusamaBivyAhar	har
anusamaBivyAhf	har
pravyAhar	har
pravyAhf	har
samAhar	har
samAhf	har
anusamAhar	har
anusamAhf	har
aBisamAhar	har
aBisamAhf	har
upasamAhar	har
upasamAhf	har
udhar	har
udhf	har
aDyudhar	har
aDyudhf	har
anUdhar	har
anUdhf	har
apodhar	har
apodhf	har
aByudhar	har
aByudhf	har
samaByudhar	har
samaByudhf	har
upodhar	har
upodhf	har
prodhar	har
prodhf	har
pratyudhar	har
pratyudhf	har
vyudhar	har
vyudhf	har
samudhar	har
samudhf	har
upahar	har
upahf	har
aByupahar	har
aByupahf	har
pratyupahar	har
pratyupahf	har
samupahar	har
samupahf	har
nihar	har
nihf	har
aBinihar	har
aBinihf	har
nirhar	har
nirhf	har
aBinirhar	har
aBinirhf	har
upanirhar	har
upanirhf	har
vinirhar	har
vinirhf	har
parAhar	har
parAhf	har
pratiparAhar	har
pratiparAhf	har
parihar	har
parihf	har
anuparihar	har
anuparihf	har
aBiparihar	har
aBiparihf	har
viparihar	har
viparihf	har
saMparihar	har
saMparihf	har
prahar	har
prahf	har
anuprahar	har
anuprahf	har
aBiprahar	har
aBiprahf	har
pratiprahar	har
pratiprahf	har
samprahar	har
samprahf	har
pratihar	har
pratihf	har
vihar	har
vihf	har
aBivihar	har
aBivihf	har
parivihar	har
parivihf	har
sampravihar	har
sampravihf	har
saMvihar	har
saMvihf	har
anusamhar	har
anusamhf	har
aBisamhar	har
aBisamhf	har
upasamhar	har
upasamhf	har
samupasamhar	har
samupasamhf	har
pratisamhar	har
pratisamhf	har
aBihary	hary
Ahary	hary
pratihary	hary
vihary	hary
anuharz	harz
anuhfz	harz
aBiharz	harz
aBihfz	harz
samaBiharz	harz
samaBihfz	harz
avaharz	harz
avahfz	harz
Aharz	harz
Ahfz	harz
vyAharz	harz
vyAhfz	harz
udharz	harz
udhfz	harz
prodharz	harz
prodhfz	harz
samudharz	harz
samudhfz	harz
niharz	harz
nihfz	harz
pariharz	harz
parihfz	harz
praharz	harz
prahfz	harz
sampraharz	harz
samprahfz	harz
pratiharz	harz
pratihfz	harz
viharz	harz
vihfz	harz
samharz	harz
samhfz	harz
parisamharz	harz
parisamhfz	harz
pratisamharz	harz
pratisamhfz	harz
atihas	has
vyatihas	has
apahas	has
aBihas	has
vyaBihas	has
avahas	has
vyavahas	has
samavahas	has
udhas	has
upahas	has
parihas	has
prahas	has
aBiprahas	has
samaBiprahas	has
samprahas	has
vihas	has
saMvihas	has
atihA	hA
anuhA	hA
apahA	hA
aBihA	hA
udhA	hA
atyudhA	hA
anUdhA	hA
aByudhA	hA
prodhA	hA
pratyudhA	hA
samudhA	hA
upahA	hA
nihA	hA
nirhA	hA
parAhA	hA
prahA	hA
atiprahA	hA
aBiprahA	hA
vihA	hA
samhA	hA
parisamhA	hA
pratisamhA	hA
vyapahA	hA
apihA	hA
avahA	hA
vyavahA	hA
samavahA	hA
AhA	hA
apAhA	hA
parihA	hA
viprahA	hA
samprahA	hA
pratihA	hA
pravihA	hA
prativihA	hA
apahi	hi
apihi	hi
Ahi	hi
parihi	hi
prahi	hi
anuprahi	hi
aBiprahi	hi
upaprahi	hi
pratiprahi	hi
samprahi	hi
samhi	hi
vyatihiMs	hiMs
avahiMs	hiMs
AhiMs	hiMs
upahiMs	hiMs
nihiMs	hiMs
pratihiMs	hiMs
vihiMs	hiMs
AhiRq	hiRq
anvAhiRq	hiRq
parihiRq	hiRq
nihIq	hIq
aDihu	hu
apahu	hu
aBihu	hu
avahu	hu
Ahu	hu
udhu	hu
aByudhu	hu
upahu	hu
nirhu	hu
prahu	hu
pratihu	hu
samhu	hu
sAmAhu	hu
anuhUrC	hUrC
vihUrC	hUrC
viheW	heW
avahel	hel
avahil	hel
vihel	hel
vihil	hel
aBihez	hez
apahnu	hnu
apihnu	hnu
nihnu	hnu
atinihnu	hnu
apanihnu	hnu
aBinihnu	hnu
vinihnu	hnu
parihnu	hnu
vihnu	hnu
apahmal	hmal
vihmal	hmal
apahras	hras
nirhras	hras
prahras	hras
pratihras	hras
anuhrAd	hrAd
nihrAd	hrAd
nirhrAd	hrAd
prahrAd	hrAd
samhrAd	hrAd
samhrI	hrI
aBihru	hru
parihru	hru
vihru	hru
AhlAd	hlAd
prahlAd	hlAd
samhlAd	hlAd
aBihvar	hvar
aBihvf	hvar
avahvar	hvar
avahvf	hvar
Ahvar	hvar
Ahvf	hvar
upahvar	hvar
upahvf	hvar
samupahvar	hvar
samupahvf	hvar
parihvar	hvar
parihvf	hvar
prahvar	hvar
prahvf	hvar
pratihvar	hvar
pratihvf	hvar
vihvar	hvar
vihvf	hvar
samhvar	hvar
samhvf	hvar
parihval	hval
prahval	hval
vihval	hval
parivihval	hval
saMvihval	hval
atihvA	hvA
atihve	hvA
anuhvA	hvA
anuhve	hvA
aBihvA	hvA
aBihve	hvA
prABihvA	hvA
prABihve	hvA
avahvA	hvA
avahve	hvA
AhvA	hvA
Ahve	hvA
atyAhvA	hvA
atyAhve	hvA
anvAhvA	hvA
anvAhve	hvA
aByAhvA	hvA
aByAhve	hvA
upAhvA	hvA
upAhve	hvA
paryAhvA	hvA
paryAhve	hvA
pratyAhvA	hvA
pratyAhve	hvA
vyAhvA	hvA
vyAhve	hvA
samAhvA	hvA
samAhve	hvA
udhvA	hvA
udhve	hvA
upahvA	hvA
upahve	hvA
paryupahvA	hvA
paryupahve	hvA
pratyupahvA	hvA
pratyupahve	hvA
samupahvA	hvA
samupahve	hvA
nihvA	hvA
nihve	hvA
nirhvA	hvA
nirhve	hvA
parihvA	hvA
parihve	hvA
prahvA	hvA
prahve	hvA
pratiprahvA	hvA
pratiprahve	hvA
pratihvA	hvA
pratihve	hvA
vihvA	hvA
vihve	hvA
samhvA	hvA
samhve	hvA
