aByaGAy	aByaGAya
paryaNKay	paryaNK
anvac	anvaYc
apAc	apAYc
avAc	avAYc
Ac	AYc
udac	udaYc
vyudac	vyudaYc
samudac	samudaYc
upAc	upAYc
nyac	nyaYc
paryac	paryaYc
pratyac	pratyaYc
vyac	vyaYc
samac	samaYc
anvar	anvf
aByar	aByf
udar	udf
nyar	nyf
nirar	nisf
pratyar	pratyf
vyar	vyf
samar	samf
aBisamar	aBisamf
aByarC	aByfC
udarC	udfC
nyarC	nyfC
nirarC	nisfC
saMnirarC	saMnisfC
vyarC	vyfC
samarC	samfC
aByarTay	aByarT
prArTay	prArT
aBiprArTay	aBiprArT
saMprArTay	saMprArT
pratyarTay	pratyarT
samarTay	samarT
aDyarD	aDyfD
anvarD	anvfD
vyarD	vyfD
samarD	samfD
anvarz	anvfz
aByarz	aByfz
paryarz	paryfz
vyarz	vyfz
samarz	samfz
aDyarz	aDyfz
udarz	udfz
nyarz	nyfz
vyaSAy	vyaSAya
anviD	anvinD
aBID	aBInD
eD	enD
parID	parInD
preD	prenD
saMpreD	saMprenD
pratID	pratInD
samiD	saminD
aBisamiD	aBisaminD
upasamiD	upasaminD
prerajy	prerajya
samizaRy	samizaRya
protkaRW	protkaRWa
samutkaRW	samutkaRWa
prollAGay	prollAGaya
upeqakIy	upeqakIya
anukaTay	anukaT
nikaTay	nikaT
parikaTay	parikaT
prakaTay	prakaT
vikaTay	vikaT
saMkaTay	saMkaT
atikar	atikf
vyatikar	vyatikf
aDikar	aDikf
anukar	anukf
apakar	apakf
pratyapakar	pratyapakf
apikar	apikf
aBikar	aBikf
araMkar	araMkf
alaMkar	alaMkf
avakar	avakf
anvavakar	anvavakf
Akar	Akf
atyAkar	atyAkf
anvAkar	anvAkf
apAkar	apAkf
vyapAkar	vyapAkf
avAkar	avAkf
udAkar	udAkf
upAkar	upAkf
aByupAkar	aByupAkf
pratyupAkar	pratyupAkf
samupAkar	samupAkf
nyAkar	nyAkf
nirAkar	nirAkf
paryAkar	paryAkf
prAkar	prAkf
samAkar	samAkf
upasamAkar	upasamAkf
izkar	izkf
utkar	utkf
upakar	upakf
pratyupakar	pratyupakf
nikar	nikf
pranikar	pranikf
vinikar	vinikf
nizkar	nizkf
aBinizkar	aBinizkf
upanizkar	upanizkf
vinizkar	vinizkf
parAkar	parAkf
parikar	parikf
prakar	prakf
viprakar	viprakf
samprakar	samprakf
pratikar	pratikf
vikar	vikf
anuvikar	anuvikf
saMkar	saMkf
aBisaMkar	aBisaMkf
upasaMkar	upasaMkf
pratisaMkar	pratisaMkf
aByavakar	aByavakf
paryavakar	paryavakf
vyavakar	vyavakf
samavakar	samavakf
ayAkar	ayAkf
samutkar	samutkf
saMnikar	saMnikf
anuparikar	anuparikf
samprakar	samprakf
pravikar	pravikf
samaDikart	samaDikft
anukart	anukft
apakart	apakft
apikart	apikft
avakart	avakft
utkart	utkft
samutkart	samutkft
upakart	upakft
nikart	nikft
vinikart	vinikft
nizkart	nizkft
parikart	parikft
prakart	prakft
vikart	vikft
aDivikart	aDivikft
saMkart	saMkft
anukarS	anukfS
avakarS	avakfS
parikarS	parikfS
prakarS	prakfS
vikarS	vikfS
atikarz	atikfz
anukarz	anukfz
apakarz	apakfz
vyapakarz	vyapakfz
aBikarz	aBikfz
avakarz	avakfz
aByavakarz	aByavakfz
vyavakarz	vyavakfz
Akarz	Akfz
apAkarz	apAkfz
vyapAkarz	vyapAkfz
aByAkarz	aByAkfz
paryAkarz	paryAkfz
pratyAkarz	pratyAkfz
vyAkarz	vyAkfz
samAkarz	samAkfz
utkarz	utkfz
apotkarz	apotkfz
pratyutkarz	pratyutkfz
samutkarz	samutkfz
upakarz	upakfz
samupakarz	samupakfz
nikarz	nikfz
saMnikarz	saMnikfz
nizkarz	nizkfz
parAkarz	parAkfz
parikarz	parikfz
prakarz	prakfz
viprakarz	viprakfz
samprakarz	samprakfz
pratikarz	pratikfz
vikarz	vikfz
saMkarz	saMkfz
anukalp	anukxp
samanukalp	samanukxp
aBikalp	aBikxp
avakalp	avakxp
Akalp	Akxp
utkalp	utkxp
upakalp	upakxp
samupakalp	samupakxp
parikalp	parikxp
prakalp	prakxp
samprakalp	samprakxp
pratikalp	pratikxp
vikalp	vikxp
saMkalp	saMkxp
upasaMkalp	upasaMkxp
anukIrtay	anukIrt
samanukIrtay	samanukIrt
samaBikIrtay	samaBikIrt
utkIrtay	utkIrt
parikIrtay	parikIrt
saMparikIrtay	saMparikIrt
prakIrtay	prakIrt
samprakIrtay	samprakIrt
saMkIrtay	saMkIrt
aBikutsay	aBikuts
anukfpAy	anukfpAya
saMketay	saMketaya
apakzA	apakzE
apikzA	apikzE
avakzA	avakzE
parikzA	parikzE
prakzA	prakzE
samprakzA	samprakzE
vikzA	vikzE
saMkzA	saMkzE
avaKaRqay	avaKaRq
AKaRqay	AKaRq
utKaRqay	utKaRq
pariKaRqay	pariKaRq
viKaRqay	viKaRq
protKA	protKE
aDigaRay	aDigaR
anugaRay	anugaR
avagaRay	avagaR
AgaRay	AgaR
parigaRay	parigaR
pragaRay	pragaR
vigaRay	vigaR
samgaRay	samgaR
anugar	anugF
apagar	apagF
apigar	apigF
aBigar	aBigF
Agar	AgF
pratyAgar	pratyAgF
upagar	upagF
pragar	pragF
sampragar	sampragF
pratigar	pratigF
aBipratigar	aBipratigF
vigar	vigF
samgar	samgF
aBisamgar	aBisamgF
avagar	avagF
udgar	udgF
pratyudgar	pratyudgF
samudgar	samudgF
nigar	nigF
nirgar	nirgF
anugarD	anugfD
aBigarD	aBigfD
pragarD	pragfD
pratigarD	pratigfD
anuguRay	anuguRaya
pariguRay	pariguRaya
praguRay	praguRaya
samguRay	samguRaya
anugfBAy	anugfBAya
samAgfBAy	samAgfBAya
udgfBAy	udgfBAya
pratigfBAy	pratigfBAya
samgfBAy	samgfBAya
AsamgfBAy	AsamgfBAya
aBigopay	aBigopaya
pragopay	pragopaya
samgopay	samgopaya
aBigopAy	aBigopAya
parigopAy	parigopAya
atigraB	atigrah
anugraB	anugrah
samanugraB	samanugrah
apagraB	apagrah
apigraB	apigrah
aBigraB	aBigrah
avagraB	avagrah
pratyavagraB	pratyavagrah
vyavagraB	vyavagrah
AgraB	Agrah
upAgraB	upAgrah
samAgraB	samAgrah
udgraB	udgrah
upodgraB	upodgrah
pratyudgraB	pratyudgrah
samudgraB	samudgrah
upagraB	upagrah
nigraB	nigrah
upanigraB	upanigrah
pratinigraB	pratinigrah
vinigraB	vinigrah
saMnigraB	saMnigrah
nirgraB	nirgrah
pratinirgraB	pratinirgrah
parigraB	parigrah
saMparigraB	saMparigrah
pragraB	pragrah
paripragraB	paripragrah
pratipragraB	pratipragrah
sampragraB	sampragrah
pratigraB	pratigrah
upapratigraB	upapratigrah
sampratigraB	sampratigrah
vigraB	vigrah
samgraB	samgrah
anusamgraB	anusamgrah
apisamgraB	apisamgrah
aBisamgraB	aBisamgrah
upasamgraB	upasamgrah
pratisamgraB	pratisamgrah
sahagraB	sahagrah
avaglA	avaglE
pariglA	pariglE
aBipariglA	aBipariglE
praglA	praglE
avaGarz	avaGfz
AGarz	AGfz
udGarz	udGfz
samudGarz	samudGfz
niGarz	niGfz
saMniGarz	saMniGfz
nirGarz	nirGfz
pariGarz	pariGfz
praGarz	praGfz
sampraGarz	sampraGfz
viGarz	viGfz
samGarz	samGfz
aBiGAtay	aBiGAtaya
avaGAtay	avaGAtaya
vyAGAtay	vyAGAtaya
upodGAtay	upodGAtaya
niGAtay	niGAtaya
nirGAtay	nirGAtaya
pratiGAtay	pratiGAtaya
viGAtay	viGAtaya
AcaraRy	AcaraRya
utcaraRy	utcaraRya
aticart	aticft
avacart	avacft
Acart	Acft
upacart	upacft
nicart	nicft
niscart	niscft
paricart	paricft
pracart	pracft
vicart	vicft
saMcart	saMcft
utcitray	utcitraya
aticitrIy	aticitrIya
aBicihnay	aBicihnaya
avacUrRay	avacUrR
vinicUrRay	vinicUrR
pracUrRay	pracUrR
ACard	ACfd
pracCard	pracCfd
upacCalay	upacCal
anuCA	anuCo
avacCA	avacCo
ACA	ACo
pracCA	pracCo
anujar	anujf
nirjar	nirjf
parijar	parijf
prajar	prajf
samjar	samjf
avajramB	avajfmB
aBijramB	aBijfmB
vyAjramB	vyAjfmB
udjramB	udjfmB
samudjramB	samudjfmB
parijramB	parijfmB
prajramB	prajfmB
vijramB	vijfmB
pravijramB	pravijfmB
samjramB	samjfmB
utwaNkay	utwaNk
niswaNkay	niswaNk
viwaNkay	viwaNk
atitar	atitF
vyatitar	vyatitF
anutar	anutF
apatar	apatF
aBitar	aBitF
avatar	avatF
samavatar	samavatF
Atar	AtF
aByAtar	aByAtF
uttar	uttF
aByuttar	aByuttF
prottar	prottF
pratyuttar	pratyuttF
samuttar	samuttF
upatar	upatF
nitar	nitF
nistar	nistF
paritar	paritF
pratar	pratF
aBipratar	aBipratF
upapratar	upapratF
vipratar	vipratF
sampratar	sampratF
pratitar	pratitF
vitar	vitF
pravitar	pravitF
saMtar	saMtF
anusaMtar	anusaMtF
aBisaMtar	aBisaMtF
atitard	atitfd
anutard	anutfd
aBitard	aBitfd
avatard	avatfd
Atard	Atfd
uttard	uttfd
upatard	upatfd
nitard	nitfd
paritard	paritfd
pratard	pratfd
sampratard	sampratfd
vitard	vitfd
saMtard	saMtfd
atitarp	atitfp
anutarp	anutfp
apatarp	apatfp
aBitarp	aBitfp
avatarp	avatfp
Atarp	Atfp
nitarp	nitfp
paritarp	paritfp
pratarp	pratfp
vitarp	vitfp
saMtarp	saMtfp
anutarz	anutfz
paritarz	paritfz
vitarz	vitfz
nistarh	nistfh
vitarh	vitfh
paritrA	paritrE
saMtrA	saMtrE
anudar	anudF
apadar	apadF
avadar	avadF
vyavadar	vyavadF
Adar	AdF
uddar	uddF
nidar	nidF
nirdar	nirdF
paridar	paridF
pradar	pradF
aBipradar	aBipradF
pratidar	pratidF
vidar	vidF
udvidar	udvidF
pravidar	pravidF
Adar	Adf
atyAdar	atyAdf
pratyAdar	pratyAdf
samAdar	samAdf
atidarp	atidfp
samuddarp	samuddfp
pradarp	pradfp
anudarB	anudfB
pidarB	pidfB
samdarB	samdfB
atidarS	atidfS
aDidarS	aDidfS
anudarS	anudfS
vyapadarS	vyapadfS
aBidarS	aBidfS
avadarS	avadfS
AdarS	AdfS
pratyAdarS	pratyAdfS
vyAdarS	vyAdfS
uddarS	uddfS
aByuddarS	aByuddfS
upadarS	upadfS
samupadarS	samupadfS
nidarS	nidfS
saMnidarS	saMnidfS
parAdarS	parAdfS
paridarS	paridfS
pradarS	pradfS
upapradarS	upapradfS
sampradarS	sampradfS
pratidarS	pratidfS
vidarS	vidfS
aBividarS	aBividfS
samdarS	samdfS
anusamdarS	anusamdfS
uddarh	uddfh
anUddarh	anUddfh
AdaSasy	AdaSasya
samdaSasy	samdaSasya
anudIDi	anudIDI
aBidIDi	aBidIDI
avadIDi	avadIDI
AdIDi	AdIDI
anvAdIDi	anvAdIDI
uddIDi	uddIDI
nidIDi	nidIDI
pradIDi	pradIDI
pratidIDi	pratidIDI
vidIDi	vidIDI
paridurmanAy	paridurmanAya
aBidUzay	aBidUzaya
upadUzay	upadUzaya
pradUzay	pradUzaya
aBipradUzay	aBipradUzaya
pratipradUzay	pratipradUzaya
vidUzay	vidUzaya
samdUzay	samdUzaya
aDiDar	aDiDf
aBiDar	aBiDf
avaDar	avaDf
paryavaDar	paryavaDf
vyavaDar	vyavaDf
ADar	ADf
nyADar	nyADf
udDar	udDf
upaDar	upaDf
anUpaDar	anUpaDf
niDar	niDf
viniDar	viniDf
nirDar	nirDf
pariDar	pariDf
praDar	praDf
sampraDar	sampraDf
pratiDar	pratiDf
viDar	viDf
samDar	samDf
apaDarz	apaDfz
aBiDarz	aBiDfz
avaDarz	avaDfz
ADarz	ADfz
upaDarz	upaDfz
pariDarz	pariDfz
praDarz	praDfz
aBipraDarz	aBipraDfz
sampraDarz	sampraDfz
pratiDarz	pratiDfz
viDarz	viDfz
samDarz	samDfz
ADunay	ADunaya
avaDUnay	avaDUnaya
viDUnay	viDUnaya
anuDUpay	anuDUpaya
avaDUpay	avaDUpaya
ADUpay	ADUpaya
udDUpay	udDUpaya
upaDUpay	upaDUpaya
nirDUpay	nirDUpaya
praDUpay	praDUpaya
viDUpay	viDUpaya
viDUpAy	viDUpAya
ADUmay	ADUmaya
praDUmay	praDUmaya
avaDUlay	avaDUlaya
udDUlay	udDUlaya
atiDyA	atiDyE
anuDyA	anuDyE
samanuDyA	samanuDyE
apaDyA	apaDyE
samapaDyA	samapaDyE
aBiDyA	aBiDyE
samaBiDyA	samaBiDyE
avaDyA	avaDyE
ADyA	ADyE
samADyA	samADyE
upaDyA	upaDyE
niDyA	niDyE
aBiniDyA	aBiniDyE
praRiDyA	praRiDyE
nirDyA	nirDyE
pariDyA	pariDyE
praDyA	praDyE
sampraDyA	sampraDyE
pratiDyA	pratiDyE
samDyA	samDyE
saMnamasy	saMnamasya
aDinart	aDinft
anunart	anunft
aBinart	aBinft
Anart	Anft
aByAnart	aByAnft
upanart	upanft
ninart	ninft
aBininart	aBininft
pariRart	pariRft
praRart	praRft
sampranart	sampranft
pratinart	pratinft
vinart	vinft
saMnart	saMnft
pratinyUNKay	pratinyUNKaya
aBipar	aBipf
samaBipar	samaBipf
avapar	avapf
Apar	Apf
samApar	samApf
utpar	utpf
upapar	upapf
nipar	nipf
nispar	nispf
paripar	paripf
saMparipar	saMparipf
prapar	prapf
aBiprapar	aBiprapf
pratipar	pratipf
saMpar	saMpf
atipar	atipf
apapar	apapf
aDiparc	aDipfc
apiparc	apipfc
Aparc	Apfc
upaparc	upapfc
nisparc	nispfc
praparc	prapfc
viparc	vipfc
saMparc	saMpfc
atipAlay	atipAl
anupAlay	anupAl
samanupAlay	samanupAl
aBipAlay	aBipAl
samaBipAlay	samaBipAl
nipAlay	nipAl
paripAlay	paripAl
saMparipAlay	saMparipAl
prapAlay	prapAl
pratipAlay	pratipAl
sampratipAlay	sampratipAl
saMpAlay	saMpAl
avapASay	avapASaya
vipASay	vipASaya
avapiRqay	avapiRq
utpiRqay	utpiRq
paripiRqay	paripiRq
saMpiRqay	saMpiRq
avapuYjay	avapuYjaya
utpuYjay	utpuYjaya
ApyA	ApyE
pratyApyA	pratyApyE
samApyA	samApyE
prapyA	prapyE
nipriyAy	nipriyAya
aBipruzAy	aBipruz
ApruzAy	Apruz
atibarh	atibfh
avabarh	avabfh
Abarh	Abfh
udbarh	udbfh
samudbarh	samudbfh
nibarh	nibfh
vinibarh	vinibfh
saMnibarh	saMnibfh
nirdarh	nirdfh
paribarh	paribfh
prabarh	prabfh
upaprabarh	upaprabfh
vibarh	vibfh
udvibarh	udvibfh
sambarh	sambfh
aBibarh	aBibfh
upabarh	upabfh
samupabarh	samupabfh
atibAzpAy	atibAzpAya
anuBar	anuBf
apaBar	apaBf
aBiBar	aBiBf
avaBar	avaBf
ABar	ABf
aDyABar	aDyABf
upABar	upABf
paryABar	paryABf
samABar	samABf
udBar	udBf
aDyudBar	aDyudBf
paryudBar	paryudBf
niBar	niBf
saMniBar	saMniBf
nirDar	nirDf
parABar	parABf
praBar	praBf
aBipraBar	aBipraBf
pratiBar	pratiBf
viBar	viBf
samBar	samBf
anusamBar	anusamBf
aBisamBar	aBisamBf
upasamBar	upasamBf
udmaTAy	udmaTAya
parimaTAy	parimaTAya
aBimanasy	aBimanasya
anumantray	anumantr
aBimantray	aBimantr
samaBimantray	samaBimantr
Amantray	Amantr
udAmantray	udAmantr
upAmantray	upAmantr
samAmantray	samAmantr
upamantray	upamantr
aByupamantray	aByupamantr
nimantray	nimantr
aBinimantray	aBinimantr
upanimantray	upanimantr
saMnimantray	saMnimantr
parimantray	parimantr
pratimantray	pratimantr
sammantray	sammantr
anumar	anumf
aBimar	aBimf
Amar	Amf
upamar	upamf
parimar	parimf
pramar	pramf
nimar	nimf
aBipramar	aBipramf
vimar	vimf
aBimarC	aBimfC
anumarj	anumfj
apamarj	apamfj
aBimarj	aBimfj
Amarj	Amfj
apAmarj	apAmfj
vyAmarj	vyAmfj
udmarj	udmfj
samudmarj	samudmfj
upamarj	upamfj
nimarj	nimfj
nirmarj	nirmfj
parAmarj	parAmfj
pramarj	pramfj
vipramarj	vipramfj
pratimarj	pratimfj
vimarj	vimfj
anuvimarj	anuvimfj
aBivimarj	aBivimfj
saMmarj	saMmfj
pramarq	pramfq
atimard	atimfd
apamard	apamfd
aBimard	aBimfd
avamard	avamfd
Amard	Amfd
aByAmard	aByAmfd
vyAmard	vyAmfd
udmard	udmfd
upamard	upamfd
nimard	nimfd
parAmard	parAmfd
parimard	parimfd
pramard	pramfd
sampramard	sampramfd
pratimard	pratimfd
vimard	vimfd
saMvimard	saMvimfd
parimarD	parimfD
vimarD	vimfD
sammarD	sammfD
atimarS	atimfS
vyatimarS	vyatimfS
aByaDimarS	aByaDimfS
anumarS	anumfS
apamarS	apamfS
aBimarS	aBimfS
pratyaBimarS	pratyaBimfS
avamarS	avamfS
anvavamarS	anvavamfS
pratyavamarS	pratyavamfS
samavamarS	samavamfS
AmarS	AmfS
udmarS	udmfS
parAmarS	parAmfS
anuparAmarS	anuparAmfS
upopamarS	upopamfS
pratiparAmarS	pratiparAmfS
parimarS	parimfS
aBipramarS	aBipramfS
pratimarS	pratimfS
vimarS	vimfS
anuvimarS	anuvimfS
pravimarS	pravimfS
sammarS	sammfS
aBisammarS	aBisammfS
apamarz	apamfz
apimarz	apimfz
Amarz	Amfz
upamarz	upamfz
parimarz	parimfz
pramarz	pramfz
vimarz	vimfz
vyatimiSray	vyatimiSr
anumiSray	anumiSr
vyAmiSray	vyAmiSr
vimiSray	vimiSr
sammiSray	sammiSr
pratisammiSray	pratisammiSr
udmudray	udmudraya
parimudray	parimudraya
vimudray	vimudraya
AmuzAy	AmuzAya
pramuzAy	pramuzAya
avamUtray	avamUtraya
pramUtray	pramUtraya
sammUtray	sammUtraya
parimfgay	parimfg
pramfgay	pramfg
vimfgay	vimfg
Amokzay	Amokz
parimokzay	parimokz
pramokzay	pramokz
sampramokzay	sampramokz
pratimokzay	pratimokz
vimokzay	vimokz
sammokzay	sammokz
aBimlA	aBimlE
AmlA	AmlE
parimlA	parimlE
viparimlA	viparimlE
pramlA	pramlE
vimlA	vimlE
upayantray	upayantr
niyantray	niyantr
samyantray	samyantr
anuraj	anuraYj
aparaj	aparaYj
aBiraj	aBiraYj
samaBiraj	samaBiraYj
udraj	udraYj
uparaj	uparaYj
pratiraj	pratiraYj
viraj	viraYj
saMraj	saMraYj
anusaMraj	anusaMraYj
aBisaMraj	aBisaMraYj
virUkzay	virUkz
nirUpay	nirUp
prarUpay	prarUp
virUpay	virUp
atilakzay	atilakz
anulakzay	anulakz
aBilakzay	aBilakz
Alakzay	Alakz
upAlakzay	upAlakz
samAlakzay	samAlakz
upalakzay	upalakz
aByupalakzay	aByupalakz
samupalakzay	samupalakz
sampratilakzay	sampratilakz
vilakzay	vilakz
saMlakzay	saMlakz
viliKApay	viliK
udliNgay	udliNg
anuvar	anuvf
apavar	apavf
apivar	apivf
aBivar	aBivf
Avar	Avf
apAvar	apAvf
upAvar	upAvf
samupAvar	samupAvf
paryAvar	paryAvf
prAvar	prAvf
saMprAvar	saMprAvf
vyAvar	vyAvf
samAvar	samAvf
udvar	udvf
nivar	nivf
upanivar	upanivf
pratinivar	pratinivf
vinivar	vinivf
saMnivar	saMnivf
nisvar	nisvf
parinisvar	parinisvf
parivar	parivf
aBiparivar	aBiparivf
saMparivar	saMparivf
pravar	pravf
prativar	prativf
vivar	vivf
saMvar	saMvf
aBisaMvar	aBisaMvf
samaBisaMvar	samaBisaMvf
parisaMvar	parisaMvf
aDivarj	aDivfj
anuvarj	anuvfj
apavarj	apavfj
vyapavarj	vyapavfj
samapavarj	samapavfj
apivarj	apivfj
aBivarj	aBivfj
avavarj	avavfj
Avarj	Avfj
apAvarj	apAvfj
prAvarj	prAvfj
vyAvarj	vyAvfj
parivyAvarj	parivyAvfj
samAvarj	samAvfj
udvarj	udvfj
nivarj	nivfj
anunivarj	anunivfj
parAvarj	parAvfj
parivarj	parivfj
saMparivarj	saMparivfj
pravarj	pravfj
anupravarj	anupravfj
prativarj	prativfj
vivarj	vivfj
saMvarj	saMvfj
acCavart	acCavft
ativart	ativft
aByativart	aByativft
vyativart	vyativft
samativart	samativft
aDivart	aDivft
anuvart	anuvft
samanuvart	samanuvft
apavart	apavft
vyapavart	vyapavft
samapavart	samapavft
apivart	apivft
aBivart	aBivft
samaBivart	samaBivft
aByavavart	aByavavft
nyavavart	nyavavft
samavavart	samavavft
Avart	Avft
anvatyAvart	anvatyAvft
anvAvart	anvAvft
apAvart	apAvft
aByAvart	aByAvft
udAvart	udAvft
upAvart	upAvft
paryupAvart	paryupAvft
nyAvart	nyAvft
paryAvart	paryAvft
anuparyAvart	anuparyAvft
apaparyAvart	apaparyAvft
aBiparyAvart	aBiparyAvft
upaparyAvart	upaparyAvft
pratiparyAvart	pratiparyAvft
viparyAvart	viparyAvft
prAvart	prAvft
pratyAvart	pratyAvft
vyAvart	vyAvft
samAvart	samAvft
aBisamAvart	aBisamAvft
upasamAvart	upasamAvft
udvart	udvft
samudvart	samudvft
upavart	upavft
samupavart	samupavft
nivart	nivft
anunivart	anunivft
aBinivart	aBinivft
upanivart	upanivft
aByupanivart	aByupanivft
parinivart	parinivft
pratinivart	pratinivft
vinivart	vinivft
samnivart	samnivft
nisvart	nisvft
aBinisvart	aBinisvft
upanisvart	upanisvft
vinisvart	vinisvft
parAvart	parAvft
viparAvart	viparAvft
parivart	parivft
anuparivart	anuparivft
viparivart	viparivft
saMparivart	saMparivft
pravart	pravft
atipravart	atipravft
anupravart	anupravft
aBipravart	aBipravft
upapravart	upapravft
paripravart	paripravft
pratipravart	pratipravft
sampravart	sampravft
aBisampravart	aBisampravft
prativart	prativft
vivart	vivft
ativivart	ativivft
anuvivart	anuvivft
saMvart	saMvft
aDisaMvart	aDisaMvft
aBisaMvart	aBisaMvft
ativarz	ativfz
anuvarz	anuvfz
aBivarz	aBivfz
samaBivarz	samaBivfz
avavarz	avavfz
Avarz	Avfz
udvarz	udvfz
nisvarz	nisvfz
parivarz	parivfz
pravarz	pravfz
aBipravarz	aBipravfz
sampravarz	sampravfz
prativarz	prativfz
vivarz	vivfz
saMvarz	saMvfz
saMvastray	saMvastraya
upavAjay	upavAjaya
nisvApay	nisvap
aDivAsay	aDivAs
anuvAsay	anuvAs
aBivAsay	aBivAs
AvAsay	AvAs
samAvAsay	samAvAs
saMvAsay	saMvAs
saMviGnay	saMviGnaya
praviSAlay	praviSAlaya
anuvIray	anuvIr
AvfzAy	AvfzAya
udvfzAy	udvfzAya
aDivyA	aDivye
apavyA	apavye
apivyA	apivye
aBivyA	aBivye
avavyA	avavye
AvyA	Avye
udvyA	udvye
upavyA	upavye
nivyA	nivye
parivyA	parivye
prativyA	prativye
saMvyA	saMvye
anusaMvyA	anusaMvye
aBisaMvyA	aBisaMvye
upasaMvyA	upasaMvye
nisvraRay	nisvraR
upavratay	upavrataya
viSakalay	viSakalaya
apaSat	apaSad
avaSat	avaSad
vyavaSat	vyavaSad
ASat	ASad
niSat	niSad
parASat	parASad
praSat	praSad
viSat	viSad
saMSat	saMSad
atiSabday	atiSabd
anuSabday	anuSabd
aBiSabday	aBiSabd
pariSabday	pariSabd
viSabday	viSabd
saMSabday	saMSabd
vyatiSar	vyatiSF
anuSar	anuSF
apiSar	apiSF
avaSar	avaSF
ASar	ASF
niSar	niSF
nisSar	nisSF
parASar	parASF
pariSar	pariSF
praSar	praSF
sampraSar	sampraSF
pratiSar	pratiSF
viSar	viSF
aBiviSar	aBiviSF
nirviSar	nirviSF
praviSar	praviSF
saMSar	saMSF
aDiSar	aDiSF
udSar	udSF
saMpariSar	saMpariSF
aBisaMSar	aBisaMSF
atiSaravyay	atiSaravyaya
praSarD	praSfD
atipraSarD	atipraSfD
avaSarD	avaSfD
viSarD	viSfD
avaSA	avaSE
ASA	ASE
niSA	niSE
atiSA	atiSE
nisSA	nisSE
saMSA	saMSE
visaMSA	visaMSE
pariSiTilay	pariSiTilaya
ASir	ASrI
atiSIlay	atiSIl
anuSIlay	anuSIl
pariSIlay	pariSIl
saMSIlay	saMSIl
aBiSyA	aBiSyE
samaBiSyA	samaBiSyE
avaSyA	avaSyE
ASyA	ASyE
praSyA	praSyE
pratiSyA	pratiSyE
saMSyA	saMSyE
aBisaMSyA	aBisaMSyE
avasaMSyA	avasaMSyE
udSraTAy	udSraTAya
viSraTAy	viSraTAya
ASravasy	ASravasya
ASruz	ASru
saMSlakzRay	saMSlakzRaya
upaSlokay	upaSlokaya
saMSlokay	saMSlokaya
udSvA	udSvi
praSvA	praSvi
viSvA	viSvi
saMSvA	saMSvi
niszWu	niszWIv
atisaMDay	atisaMDaya
pratisaMDay	pratisaMDaya
visapary	visaparya
aDisaBAjay	aDisaBAj
acCasar	acCasf
atisar	atisf
anusar	anusf
atyanusar	atyanusf
aByanusar	aByanusf
vyanusar	vyanusf
apasar	apasf
vyapasar	vyapasf
apisar	apisf
aBisar	aBisf
atyaBisar	atyaBisf
avasar	avasf
aByavasar	aByavasf
samavasar	samavasf
Asar	Asf
atyAsar	atyAsf
apAsar	apAsf
pratyAsar	pratyAsf
vyAsar	vyAsf
utsar	utsf
anUtsar	anUtsf
protsar	protsf
pratyutsar	pratyutsf
samutsar	samutsf
upasar	upasf
aByupasar	aByupasf
pratyupasar	pratyupasf
samupasar	samupasf
nisar	nisf
vinisar	vinisf
aBinissar	aBinissf
samaBinissar	samaBinissf
vinissar	vinissf
anuvinissar	anuvinissf
parAsar	parAsf
upaparAsar	upaparAsf
parisar	parisf
prasar	prasf
atiprasar	atiprasf
anuprasar	anuprasf
aBiprasar	aBiprasf
upaprasar	upaprasf
pratiprasar	pratiprasf
viprasar	viprasf
samprasar	samprasf
pratisar	pratisf
vipratisar	vipratisf
visar	visf
anuvisar	anuvisf
pravisar	pravisf
saMsar	saMsf
anusaMsar	anusaMsf
aBisaMsar	aBisaMsf
upasaMsar	upasaMsf
atisarj	atisfj
aByatisarj	aByatisfj
samatisarj	samatisfj
anusarj	anusfj
aByanusarj	aByanusfj
apasarj	apasfj
vyapasarj	vyapasfj
apisarj	apisfj
pratyapisarj	pratyapisfj
aBisarj	aBisfj
avasarj	avasfj
atyavasarj	atyavasfj
anvavasarj	anvavasfj
aByavasarj	aByavasfj
upAvasarj	upAvasfj
nyavasarj	nyavasfj
pratyavasarj	pratyavasfj
vyavasarj	vyavasfj
samavasarj	samavasfj
Asarj	Asfj
aDyAsarj	aDyAsfj
upAsarj	upAsfj
samAsarj	samAsfj
utsarj	utsfj
anUtsarj	anUtsfj
aByutsarj	aByutsfj
paryutsarj	paryutsfj
vyutsarj	vyutsfj
samutsarj	samutsfj
upasarj	upasfj
nirupasarj	nirupasfj
samupasarj	samupasfj
nisarj	nisfj
pratinisarj	pratinisfj
saMnisarj	saMnisfj
nissarj	nissfj
aBinissarj	aBinissfj
pratinissarj	pratinissfj
parAsarj	parAsfj
parisarj	parisfj
prasarj	prasfj
anuprasarj	anuprasfj
pariprasarj	pariprasfj
pratiprasarj	pratiprasfj
visarj	visfj
anuvisarj	anuvisfj
aBivisarj	aBivisfj
udvisarj	udvisfj
prativisarj	prativisfj
saMvisarj	saMvisfj
saMsarj	saMsfj
anusaMsarj	anusaMsfj
upasaMsarj	upasaMsfj
parisaMsarj	parisaMsfj
pratisaMsarj	pratisaMsfj
atisarp	atisfp
vyatisarp	vyatisfp
aDisarp	aDisfp
samaDisarp	samaDisfp
anusarp	anusfp
samanusarp	samanusfp
apasarp	apasfp
pratyapasarp	pratyapasfp
vyapasarp	vyapasfp
aBisarp	aBisfp
avasarp	avasfp
anvavasarp	anvavasfp
upAvasarp	upAvasfp
paryavasarp	paryavasfp
pratyavasarp	pratyavasfp
vyavasarp	vyavasfp
Asarp	Asfp
udAsarp	udAsfp
upodAsarp	upodAsfp
samAsarp	samAsfp
utsarp	utsfp
protsarp	protsfp
samutsarp	samutsfp
upasarp	upasfp
samupasarp	samupasfp
vinisarp	vinisfp
nissarp	nissfp
aBinissarp	aBinissfp
vinissarp	vinissfp
parisarp	parisfp
prasarp	prasfp
anuprasarp	anuprasfp
aBiprasarp	aBiprasfp
pratiprasarp	pratiprasfp
viprasarp	viprasfp
samprasarp	samprasfp
visarp	visfp
anuvisarp	anuvisfp
saMsarp	saMsfp
anusaMsarp	anusaMsfp
upasaMsarp	upasaMsfp
visaMsarp	visaMsfp
aBisA	aBiso
avasA	avaso
aDyavasA	aDyavaso
anvavasA	anvavaso
udavasA	udavaso
aByudavasA	aByudavaso
upAvasA	upAvaso
niravasA	niravaso
prAvasA	prAvaso
pratyavasA	pratyavaso
vyavasA	vyavaso
anuvyavasA	anuvyavaso
saMvyavasA	saMvyavaso
samavasA	samavaso
nisA	niso
pariRisA	pariRiso
praRisA	praRiso
parisA	pariso
prasA	praso
visA	viso
saMsA	saMso
aBisAntvay	aBisAntv
aBisUcay	aBisUc
AsUtray	AsUtr
samAsUtray	samAsUtr
visUtray	visUtr
atiskad	atiskand
aDiskad	aDiskand
anuskad	anuskand
aBiskad	aBiskand
pratyaBiskad	pratyaBiskand
avaskad	avaskand
aByavaskad	aByavaskand
paryavaskad	paryavaskand
pratyavaskad	pratyavaskand
samavaskad	samavaskand
Askad	Askand
samAskad	samAskand
utskad	utskand
upaskad	upaskand
pariskad	pariskand
praskad	praskand
aBipraskad	aBipraskand
viskad	viskand
saMskad	saMskand
aBiskaBAy	aBiskaB
viskaBAy	viskaB
viskuB	viskumB
upastaBAy	upastaB
vizwaBAy	vizwaB
anustar	anustf
aBizwar	aBizwf
avastar	avastf
samavastar	samavastf
Astar	Astf
upAstar	upAstf
prAstar	prAstf
pratyAstar	pratyAstf
samAstar	samAstf
upastar	upastf
nizwar	nizwf
nisstar	nisstf
parizwar	parizwf
prastar	prastf
anuprastar	anuprastf
aBiprastar	aBiprastf
upaprastar	upaprastf
vizwar	vizwf
ativizwar	ativizwf
anuvizwar	anuvizwf
avizwar	avizwf
pravizwar	pravizwf
saMstar	saMstf
aBisaMstar	aBisaMstf
parisaMstar	parisaMstf
nizwyA	nizwyE
prastyA	prastyE
saMstyA	saMstyE
apaspar	apaspf
avaspar	avaspf
Aspar	Aspf
nisspar	nisspf
vispar	vispf
aDisparS	aDispfS
anusparS	anuspfS
apasparS	apaspfS
aBisparS	aBispfS
AsparS	AspfS
utsparS	utspfS
upasparS	upaspfS
pratyupasparS	pratyupaspfS
samupasparS	samupaspfS
nisparS	nispfS
parisparS	parispfS
saMsparS	saMspfS
anusaMsparS	anusaMspfS
aBisaMsparS	aBisaMspfS
parisaMsparS	parisaMspfS
praspUrD	praspfD
saMspfhay	saMspfh
anusmar	anusmf
pratyanusmar	pratyanusmf
samanusmar	samanusmf
apasmar	apasmf
upasmar	upasmf
nismar	nismf
vinismar	vinismf
prasmar	prasmf
pratismar	pratismf
vismar	vismf
saMsmar	saMsmf
anusaMsmar	anusaMsmf
aBisaMsmar	aBisaMsmf
acCasyad	acCasyand
atisyad	atisyand
anusyad	anusyand
aBisyad	aBisyand
samaBisyad	samaBisyand
avasyad	avasyand
aByavasyad	aByavasyand
Asyad	Asyand
upAsyad	upAsyand
upasyad	upasyand
nisyad	nisyand
aBinisyad	aBinisyand
nissyad	nissyand
parisyad	parisyand
prasyad	prasyand
pariprasyad	pariprasyand
visyad	visyand
anuvisyad	anuvisyand
aBivisyad	aBivisyand
saMsyad	saMsyand
anusaMsyad	anusaMsyand
prasrA	prasrE
atisvar	atisvf
anusvar	anusvf
samanusvar	samanusvf
aBisvar	aBisvf
avasvar	avasvf
upasvar	upasvf
nisvar	nisvf
nissvar	nissvf
parisvar	parisvf
prasvar	prasvf
pratisvar	pratisvf
saMsvar	saMsvf
aBisaMsvar	aBisaMsvf
pratyAsvar	pratyAsvf
atihar	atihf
aByatihar	aByatihf
pratyatihar	pratyatihf
vyatihar	vyatihf
aDihar	aDihf
anuhar	anuhf
vyapahar	vyapahf
aBihar	aBihf
pratyaBihar	pratyaBihf
avahar	avahf
anvavahar	anvavahf
aByavahar	aByavahf
upAvahar	upAvahf
aByupAvahar	aByupAvahf
pratyavahar	pratyavahf
vyavahar	vyavahf
saMvyavahar	saMvyavahf
samavahar	samavahf
Ahar	Ahf
atyAhar	atyAhf
aDyAhar	aDyAhf
anvAhar	anvAhf
samanvAhar	samanvAhf
apyAhar	apyAhf
aByAhar	aByAhf
udAhar	udAhf
anUdAhar	anUdAhf
aByudAhar	aByudAhf
upodAhar	upodAhf
pratyudAhar	pratyudAhf
samudAhar	samudAhf
upAhar	upAhf
aByupAhar	aByupAhf
pratyupAhar	pratyupAhf
samupAhar	samupAhf
upanyAhar	upanyAhf
paryAhar	paryAhf
pratiparyAhar	pratiparyAhf
pratyAhar	pratyAhf
vyAhar	vyAhf
ativyAhar	ativyAhf
anuvyAhar	anuvyAhf
apavyAhar	apavyAhf
aBivyAhar	aBivyAhf
samaBivyAhar	samaBivyAhf
anusamaBivyAhar	anusamaBivyAhf
pravyAhar	pravyAhf
samAhar	samAhf
anusamAhar	anusamAhf
aBisamAhar	aBisamAhf
upasamAhar	upasamAhf
udhar	udhf
aDyudhar	aDyudhf
anUdhar	anUdhf
apodhar	apodhf
aByudhar	aByudhf
samaByudhar	samaByudhf
upodhar	upodhf
prodhar	prodhf
pratyudhar	pratyudhf
vyudhar	vyudhf
samudhar	samudhf
upahar	upahf
aByupahar	aByupahf
pratyupahar	pratyupahf
samupahar	samupahf
nihar	nihf
aBinihar	aBinihf
nirhar	nirhf
aBinirhar	aBinirhf
upanirhar	upanirhf
vinirhar	vinirhf
parAhar	parAhf
pratiparAhar	pratiparAhf
parihar	parihf
anuparihar	anuparihf
aBiparihar	aBiparihf
viparihar	viparihf
saMparihar	saMparihf
prahar	prahf
anuprahar	anuprahf
aBiprahar	aBiprahf
pratiprahar	pratiprahf
samprahar	samprahf
pratihar	pratihf
vihar	vihf
aBivihar	aBivihf
parivihar	parivihf
sampravihar	sampravihf
saMvihar	saMvihf
anusamhar	anusamhf
aBisamhar	aBisamhf
upasamhar	upasamhf
samupasamhar	samupasamhf
pratisamhar	pratisamhf
anuharz	anuhfz
aBiharz	aBihfz
samaBiharz	samaBihfz
avaharz	avahfz
Aharz	Ahfz
vyAharz	vyAhfz
udharz	udhfz
prodharz	prodhfz
samudharz	samudhfz
niharz	nihfz
pariharz	parihfz
praharz	prahfz
sampraharz	samprahfz
pratiharz	pratihfz
viharz	vihfz
samharz	samhfz
parisamharz	parisamhfz
pratisamharz	pratisamhfz
avahel	avahil
vihel	vihil
aBihvar	aBihvf
avahvar	avahvf
Ahvar	Ahvf
upahvar	upahvf
samupahvar	samupahvf
parihvar	parihvf
prahvar	prahvf
pratihvar	pratihvf
vihvar	vihvf
samhvar	samhvf
atihvA	atihve
anuhvA	anuhve
aBihvA	aBihve
prABihvA	prABihve
avahvA	avahve
AhvA	Ahve
atyAhvA	atyAhve
anvAhvA	anvAhve
aByAhvA	aByAhve
upAhvA	upAhve
paryAhvA	paryAhve
pratyAhvA	pratyAhve
vyAhvA	vyAhve
samAhvA	samAhve
udhvA	udhve
upahvA	upahve
paryupahvA	paryupahve
pratyupahvA	pratyupahve
samupahvA	samupahve
nihvA	nihve
nirhvA	nirhve
parihvA	parihve
prahvA	prahve
pratiprahvA	pratiprahve
pratihvA	pratihve
vihvA	vihve
samhvA	samhve
