; alternate spellings for mw headwords
; Part 1:  based on pw prefixed verbs, which also occur in mw
;  but with different spelling.
; The prefixed verb records are sub-headwords of pw verb records,
; but in mw, they are separate headwords.
; format:  mw spelling <tab> alternate pw spelling
; ---------------------------------------------------
; ---------------------------------------------------
aByaGAya	aByaGAy
paryaNK	paryaNKay
anvaYc	anvac
apAYc	apAc
avAYc	avAc
AYc	Ac
udaYc	udac
vyudaYc	vyudac
samudaYc	samudac
upAYc	upAc
nyaYc	nyac
paryaYc	paryac
pratyaYc	pratyac
vyaYc	vyac
samaYc	samac
anvf	anvar
aByf	aByar
udf	udar
nyf	nyar
nisf	nirar
pratyf	pratyar
vyf	vyar
samf	samar
aBisamf	aBisamar
aByfC	aByarC
udfC	udarC
nyfC	nyarC
nisfC	nirarC
saMnisfC	saMnirarC
vyfC	vyarC
samfC	samarC
aByarT	aByarTay
prArT	prArTay
aBiprArT	aBiprArTay
saMprArT	saMprArTay
pratyarT	pratyarTay
samarT	samarTay
aDyfD	aDyarD
anvfD	anvarD
vyfD	vyarD
samfD	samarD
anvfz	anvarz
aByfz	aByarz
paryfz	paryarz
vyfz	vyarz
samfz	samarz
aDyfz	aDyarz
udfz	udarz
nyfz	nyarz
vyaSAya	vyaSAy
anvinD	anviD
aBInD	aBID
enD	eD
parInD	parID
prenD	preD
saMprenD	saMpreD
pratInD	pratID
saminD	samiD
aBisaminD	aBisamiD
upasaminD	upasamiD
prerajya	prerajy
samizaRya	samizaRy
protkaRWa	protkaRW
samutkaRWa	samutkaRW
prollAGaya	prollAGay
upeqakIya	upeqakIy
anukaT	anukaTay
nikaT	nikaTay
parikaT	parikaTay
prakaT	prakaTay
vikaT	vikaTay
saMkaT	saMkaTay
atikf	atikar
vyatikf	vyatikar
aDikf	aDikar
anukf	anukar
apakf	apakar
pratyapakf	pratyapakar
apikf	apikar
aBikf	aBikar
araMkf	araMkar
alaMkf	alaMkar
avakf	avakar
anvavakf	anvavakar
Akf	Akar
atyAkf	atyAkar
anvAkf	anvAkar
apAkf	apAkar
vyapAkf	vyapAkar
avAkf	avAkar
udAkf	udAkar
upAkf	upAkar
aByupAkf	aByupAkar
pratyupAkf	pratyupAkar
samupAkf	samupAkar
nyAkf	nyAkar
nirAkf	nirAkar
paryAkf	paryAkar
prAkf	prAkar
samAkf	samAkar
upasamAkf	upasamAkar
izkf	izkar
utkf	utkar
upakf	upakar
pratyupakf	pratyupakar
nikf	nikar
pranikf	pranikar
vinikf	vinikar
nizkf	nizkar
aBinizkf	aBinizkar
upanizkf	upanizkar
vinizkf	vinizkar
parAkf	parAkar
parikf	parikar
prakf	prakar
viprakf	viprakar
samprakf	samprakar
pratikf	pratikar
vikf	vikar
anuvikf	anuvikar
saMkf	saMkar
aBisaMkf	aBisaMkar
upasaMkf	upasaMkar
pratisaMkf	pratisaMkar
aByavakf	aByavakar
paryavakf	paryavakar
vyavakf	vyavakar
samavakf	samavakar
ayAkf	ayAkar
samutkf	samutkar
saMnikf	saMnikar
anuparikf	anuparikar
samprakf	samprakar
pravikf	pravikar
samaDikft	samaDikart
anukft	anukart
apakft	apakart
apikft	apikart
avakft	avakart
utkft	utkart
samutkft	samutkart
upakft	upakart
nikft	nikart
vinikft	vinikart
nizkft	nizkart
parikft	parikart
prakft	prakart
vikft	vikart
aDivikft	aDivikart
saMkft	saMkart
anukfS	anukarS
avakfS	avakarS
parikfS	parikarS
prakfS	prakarS
vikfS	vikarS
atikfz	atikarz
anukfz	anukarz
apakfz	apakarz
vyapakfz	vyapakarz
aBikfz	aBikarz
avakfz	avakarz
aByavakfz	aByavakarz
vyavakfz	vyavakarz
Akfz	Akarz
apAkfz	apAkarz
vyapAkfz	vyapAkarz
aByAkfz	aByAkarz
paryAkfz	paryAkarz
pratyAkfz	pratyAkarz
vyAkfz	vyAkarz
samAkfz	samAkarz
utkfz	utkarz
apotkfz	apotkarz
pratyutkfz	pratyutkarz
samutkfz	samutkarz
upakfz	upakarz
samupakfz	samupakarz
nikfz	nikarz
saMnikfz	saMnikarz
nizkfz	nizkarz
parAkfz	parAkarz
parikfz	parikarz
prakfz	prakarz
viprakfz	viprakarz
samprakfz	samprakarz
pratikfz	pratikarz
vikfz	vikarz
saMkfz	saMkarz
anukxp	anukalp
samanukxp	samanukalp
aBikxp	aBikalp
avakxp	avakalp
Akxp	Akalp
utkxp	utkalp
upakxp	upakalp
samupakxp	samupakalp
parikxp	parikalp
prakxp	prakalp
samprakxp	samprakalp
pratikxp	pratikalp
vikxp	vikalp
saMkxp	saMkalp
upasaMkxp	upasaMkalp
anukIrt	anukIrtay
samanukIrt	samanukIrtay
samaBikIrt	samaBikIrtay
utkIrt	utkIrtay
parikIrt	parikIrtay
saMparikIrt	saMparikIrtay
prakIrt	prakIrtay
samprakIrt	samprakIrtay
saMkIrt	saMkIrtay
aBikuts	aBikutsay
anukfpAya	anukfpAy
saMketaya	saMketay
apakzE	apakzA
apikzE	apikzA
avakzE	avakzA
parikzE	parikzA
prakzE	prakzA
samprakzE	samprakzA
vikzE	vikzA
saMkzE	saMkzA
avaKaRq	avaKaRqay
AKaRq	AKaRqay
utKaRq	utKaRqay
pariKaRq	pariKaRqay
viKaRq	viKaRqay
protKE	protKA
aDigaR	aDigaRay
anugaR	anugaRay
avagaR	avagaRay
AgaR	AgaRay
parigaR	parigaRay
pragaR	pragaRay
vigaR	vigaRay
samgaR	samgaRay
anugF	anugar
apagF	apagar
apigF	apigar
aBigF	aBigar
AgF	Agar
pratyAgF	pratyAgar
upagF	upagar
pragF	pragar
sampragF	sampragar
pratigF	pratigar
aBipratigF	aBipratigar
vigF	vigar
samgF	samgar
aBisamgF	aBisamgar
avagF	avagar
udgF	udgar
pratyudgF	pratyudgar
samudgF	samudgar
nigF	nigar
nirgF	nirgar
anugfD	anugarD
aBigfD	aBigarD
pragfD	pragarD
pratigfD	pratigarD
anuguRaya	anuguRay
pariguRaya	pariguRay
praguRaya	praguRay
samguRaya	samguRay
anugfBAya	anugfBAy
samAgfBAya	samAgfBAy
udgfBAya	udgfBAy
pratigfBAya	pratigfBAy
samgfBAya	samgfBAy
AsamgfBAya	AsamgfBAy
aBigopaya	aBigopay
pragopaya	pragopay
samgopaya	samgopay
aBigopAya	aBigopAy
parigopAya	parigopAy
atigrah	atigraB
anugrah	anugraB
samanugrah	samanugraB
apagrah	apagraB
apigrah	apigraB
aBigrah	aBigraB
avagrah	avagraB
pratyavagrah	pratyavagraB
vyavagrah	vyavagraB
Agrah	AgraB
upAgrah	upAgraB
samAgrah	samAgraB
udgrah	udgraB
upodgrah	upodgraB
pratyudgrah	pratyudgraB
samudgrah	samudgraB
upagrah	upagraB
nigrah	nigraB
upanigrah	upanigraB
pratinigrah	pratinigraB
vinigrah	vinigraB
saMnigrah	saMnigraB
nirgrah	nirgraB
pratinirgrah	pratinirgraB
parigrah	parigraB
saMparigrah	saMparigraB
pragrah	pragraB
paripragrah	paripragraB
pratipragrah	pratipragraB
sampragrah	sampragraB
pratigrah	pratigraB
upapratigrah	upapratigraB
sampratigrah	sampratigraB
vigrah	vigraB
samgrah	samgraB
anusamgrah	anusamgraB
apisamgrah	apisamgraB
aBisamgrah	aBisamgraB
upasamgrah	upasamgraB
pratisamgrah	pratisamgraB
sahagrah	sahagraB
avaglE	avaglA
pariglE	pariglA
aBipariglE	aBipariglA
praglE	praglA
avaGfz	avaGarz
AGfz	AGarz
udGfz	udGarz
samudGfz	samudGarz
niGfz	niGarz
saMniGfz	saMniGarz
nirGfz	nirGarz
pariGfz	pariGarz
praGfz	praGarz
sampraGfz	sampraGarz
viGfz	viGarz
samGfz	samGarz
aBiGAtaya	aBiGAtay
avaGAtaya	avaGAtay
vyAGAtaya	vyAGAtay
upodGAtaya	upodGAtay
niGAtaya	niGAtay
nirGAtaya	nirGAtay
pratiGAtaya	pratiGAtay
viGAtaya	viGAtay
AcaraRya	AcaraRy
utcaraRya	utcaraRy
aticft	aticart
avacft	avacart
Acft	Acart
upacft	upacart
nicft	nicart
niscft	niscart
paricft	paricart
pracft	pracart
vicft	vicart
saMcft	saMcart
utcitraya	utcitray
aticitrIya	aticitrIy
aBicihnaya	aBicihnay
avacUrR	avacUrRay
vinicUrR	vinicUrRay
pracUrR	pracUrRay
ACfd	ACard
pracCfd	pracCard
upacCal	upacCalay
anuCo	anuCA
avacCo	avacCA
ACo	ACA
pracCo	pracCA
anujf	anujar
nirjf	nirjar
parijf	parijar
prajf	prajar
samjf	samjar
avajfmB	avajramB
aBijfmB	aBijramB
vyAjfmB	vyAjramB
udjfmB	udjramB
samudjfmB	samudjramB
parijfmB	parijramB
prajfmB	prajramB
vijfmB	vijramB
pravijfmB	pravijramB
samjfmB	samjramB
utwaNk	utwaNkay
niswaNk	niswaNkay
viwaNk	viwaNkay
atitF	atitar
vyatitF	vyatitar
anutF	anutar
apatF	apatar
aBitF	aBitar
avatF	avatar
samavatF	samavatar
AtF	Atar
aByAtF	aByAtar
uttF	uttar
aByuttF	aByuttar
prottF	prottar
pratyuttF	pratyuttar
samuttF	samuttar
upatF	upatar
nitF	nitar
nistF	nistar
paritF	paritar
pratF	pratar
aBipratF	aBipratar
upapratF	upapratar
vipratF	vipratar
sampratF	sampratar
pratitF	pratitar
vitF	vitar
pravitF	pravitar
saMtF	saMtar
anusaMtF	anusaMtar
aBisaMtF	aBisaMtar
atitfd	atitard
anutfd	anutard
aBitfd	aBitard
avatfd	avatard
Atfd	Atard
uttfd	uttard
upatfd	upatard
nitfd	nitard
paritfd	paritard
pratfd	pratard
sampratfd	sampratard
vitfd	vitard
saMtfd	saMtard
atitfp	atitarp
anutfp	anutarp
apatfp	apatarp
aBitfp	aBitarp
avatfp	avatarp
Atfp	Atarp
nitfp	nitarp
paritfp	paritarp
pratfp	pratarp
vitfp	vitarp
saMtfp	saMtarp
anutfz	anutarz
paritfz	paritarz
vitfz	vitarz
nistfh	nistarh
vitfh	vitarh
paritrE	paritrA
saMtrE	saMtrA
anudF	anudar
apadF	apadar
avadF	avadar
vyavadF	vyavadar
AdF	Adar
uddF	uddar
nidF	nidar
nirdF	nirdar
paridF	paridar
pradF	pradar
aBipradF	aBipradar
pratidF	pratidar
vidF	vidar
udvidF	udvidar
pravidF	pravidar
Adf	Adar
atyAdf	atyAdar
pratyAdf	pratyAdar
samAdf	samAdar
atidfp	atidarp
samuddfp	samuddarp
pradfp	pradarp
anudfB	anudarB
pidfB	pidarB
samdfB	samdarB
atidfS	atidarS
aDidfS	aDidarS
anudfS	anudarS
vyapadfS	vyapadarS
aBidfS	aBidarS
avadfS	avadarS
AdfS	AdarS
pratyAdfS	pratyAdarS
vyAdfS	vyAdarS
uddfS	uddarS
aByuddfS	aByuddarS
upadfS	upadarS
samupadfS	samupadarS
nidfS	nidarS
saMnidfS	saMnidarS
parAdfS	parAdarS
paridfS	paridarS
pradfS	pradarS
upapradfS	upapradarS
sampradfS	sampradarS
pratidfS	pratidarS
vidfS	vidarS
aBividfS	aBividarS
samdfS	samdarS
anusamdfS	anusamdarS
uddfh	uddarh
anUddfh	anUddarh
AdaSasya	AdaSasy
samdaSasya	samdaSasy
anudIDI	anudIDi
aBidIDI	aBidIDi
avadIDI	avadIDi
AdIDI	AdIDi
anvAdIDI	anvAdIDi
uddIDI	uddIDi
nidIDI	nidIDi
pradIDI	pradIDi
pratidIDI	pratidIDi
vidIDI	vidIDi
paridurmanAya	paridurmanAy
aBidUzaya	aBidUzay
upadUzaya	upadUzay
pradUzaya	pradUzay
aBipradUzaya	aBipradUzay
pratipradUzaya	pratipradUzay
vidUzaya	vidUzay
samdUzaya	samdUzay
aDiDf	aDiDar
aBiDf	aBiDar
avaDf	avaDar
paryavaDf	paryavaDar
vyavaDf	vyavaDar
ADf	ADar
nyADf	nyADar
udDf	udDar
upaDf	upaDar
anUpaDf	anUpaDar
niDf	niDar
viniDf	viniDar
nirDf	nirDar
pariDf	pariDar
praDf	praDar
sampraDf	sampraDar
pratiDf	pratiDar
viDf	viDar
samDf	samDar
apaDfz	apaDarz
aBiDfz	aBiDarz
avaDfz	avaDarz
ADfz	ADarz
upaDfz	upaDarz
pariDfz	pariDarz
praDfz	praDarz
aBipraDfz	aBipraDarz
sampraDfz	sampraDarz
pratiDfz	pratiDarz
viDfz	viDarz
samDfz	samDarz
ADunaya	ADunay
avaDUnaya	avaDUnay
viDUnaya	viDUnay
anuDUpaya	anuDUpay
avaDUpaya	avaDUpay
ADUpaya	ADUpay
udDUpaya	udDUpay
upaDUpaya	upaDUpay
nirDUpaya	nirDUpay
praDUpaya	praDUpay
viDUpaya	viDUpay
viDUpAya	viDUpAy
ADUmaya	ADUmay
praDUmaya	praDUmay
avaDUlaya	avaDUlay
udDUlaya	udDUlay
atiDyE	atiDyA
anuDyE	anuDyA
samanuDyE	samanuDyA
apaDyE	apaDyA
samapaDyE	samapaDyA
aBiDyE	aBiDyA
samaBiDyE	samaBiDyA
avaDyE	avaDyA
ADyE	ADyA
samADyE	samADyA
upaDyE	upaDyA
niDyE	niDyA
aBiniDyE	aBiniDyA
praRiDyE	praRiDyA
nirDyE	nirDyA
pariDyE	pariDyA
praDyE	praDyA
sampraDyE	sampraDyA
pratiDyE	pratiDyA
samDyE	samDyA
saMnamasya	saMnamasy
aDinft	aDinart
anunft	anunart
aBinft	aBinart
Anft	Anart
aByAnft	aByAnart
upanft	upanart
ninft	ninart
aBininft	aBininart
pariRft	pariRart
praRft	praRart
sampranft	sampranart
pratinft	pratinart
vinft	vinart
saMnft	saMnart
pratinyUNKaya	pratinyUNKay
aBipf	aBipar
samaBipf	samaBipar
avapf	avapar
Apf	Apar
samApf	samApar
utpf	utpar
upapf	upapar
nipf	nipar
nispf	nispar
paripf	paripar
saMparipf	saMparipar
prapf	prapar
aBiprapf	aBiprapar
pratipf	pratipar
saMpf	saMpar
atipf	atipar
apapf	apapar
aDipfc	aDiparc
apipfc	apiparc
Apfc	Aparc
upapfc	upaparc
nispfc	nisparc
prapfc	praparc
vipfc	viparc
saMpfc	saMparc
atipAl	atipAlay
anupAl	anupAlay
samanupAl	samanupAlay
aBipAl	aBipAlay
samaBipAl	samaBipAlay
nipAl	nipAlay
paripAl	paripAlay
saMparipAl	saMparipAlay
prapAl	prapAlay
pratipAl	pratipAlay
sampratipAl	sampratipAlay
saMpAl	saMpAlay
avapASaya	avapASay
vipASaya	vipASay
avapiRq	avapiRqay
utpiRq	utpiRqay
paripiRq	paripiRqay
saMpiRq	saMpiRqay
avapuYjaya	avapuYjay
utpuYjaya	utpuYjay
ApyE	ApyA
pratyApyE	pratyApyA
samApyE	samApyA
prapyE	prapyA
nipriyAya	nipriyAy
aBipruz	aBipruzAy
Apruz	ApruzAy
atibfh	atibarh
avabfh	avabarh
Abfh	Abarh
udbfh	udbarh
samudbfh	samudbarh
nibfh	nibarh
vinibfh	vinibarh
saMnibfh	saMnibarh
nirdfh	nirdarh
paribfh	paribarh
prabfh	prabarh
upaprabfh	upaprabarh
vibfh	vibarh
udvibfh	udvibarh
sambfh	sambarh
aBibfh	aBibarh
upabfh	upabarh
samupabfh	samupabarh
atibAzpAya	atibAzpAy
anuBf	anuBar
apaBf	apaBar
aBiBf	aBiBar
avaBf	avaBar
ABf	ABar
aDyABf	aDyABar
upABf	upABar
paryABf	paryABar
samABf	samABar
udBf	udBar
aDyudBf	aDyudBar
paryudBf	paryudBar
niBf	niBar
saMniBf	saMniBar
nirDf	nirDar
parABf	parABar
praBf	praBar
aBipraBf	aBipraBar
pratiBf	pratiBar
viBf	viBar
samBf	samBar
anusamBf	anusamBar
aBisamBf	aBisamBar
upasamBf	upasamBar
udmaTAya	udmaTAy
parimaTAya	parimaTAy
aBimanasya	aBimanasy
anumantr	anumantray
aBimantr	aBimantray
samaBimantr	samaBimantray
Amantr	Amantray
udAmantr	udAmantray
upAmantr	upAmantray
samAmantr	samAmantray
upamantr	upamantray
aByupamantr	aByupamantray
nimantr	nimantray
aBinimantr	aBinimantray
upanimantr	upanimantray
saMnimantr	saMnimantray
parimantr	parimantray
pratimantr	pratimantray
sammantr	sammantray
anumf	anumar
aBimf	aBimar
Amf	Amar
upamf	upamar
parimf	parimar
pramf	pramar
nimf	nimar
aBipramf	aBipramar
vimf	vimar
aBimfC	aBimarC
anumfj	anumarj
apamfj	apamarj
aBimfj	aBimarj
Amfj	Amarj
apAmfj	apAmarj
vyAmfj	vyAmarj
udmfj	udmarj
samudmfj	samudmarj
upamfj	upamarj
nimfj	nimarj
nirmfj	nirmarj
parAmfj	parAmarj
pramfj	pramarj
vipramfj	vipramarj
pratimfj	pratimarj
vimfj	vimarj
anuvimfj	anuvimarj
aBivimfj	aBivimarj
saMmfj	saMmarj
pramfq	pramarq
atimfd	atimard
apamfd	apamard
aBimfd	aBimard
avamfd	avamard
Amfd	Amard
aByAmfd	aByAmard
vyAmfd	vyAmard
udmfd	udmard
upamfd	upamard
nimfd	nimard
parAmfd	parAmard
parimfd	parimard
pramfd	pramard
sampramfd	sampramard
pratimfd	pratimard
vimfd	vimard
saMvimfd	saMvimard
parimfD	parimarD
vimfD	vimarD
sammfD	sammarD
atimfS	atimarS
vyatimfS	vyatimarS
aByaDimfS	aByaDimarS
anumfS	anumarS
apamfS	apamarS
aBimfS	aBimarS
pratyaBimfS	pratyaBimarS
avamfS	avamarS
anvavamfS	anvavamarS
pratyavamfS	pratyavamarS
samavamfS	samavamarS
AmfS	AmarS
udmfS	udmarS
parAmfS	parAmarS
anuparAmfS	anuparAmarS
upopamfS	upopamarS
pratiparAmfS	pratiparAmarS
parimfS	parimarS
aBipramfS	aBipramarS
pratimfS	pratimarS
vimfS	vimarS
anuvimfS	anuvimarS
pravimfS	pravimarS
sammfS	sammarS
aBisammfS	aBisammarS
apamfz	apamarz
apimfz	apimarz
Amfz	Amarz
upamfz	upamarz
parimfz	parimarz
pramfz	pramarz
vimfz	vimarz
vyatimiSr	vyatimiSray
anumiSr	anumiSray
vyAmiSr	vyAmiSray
vimiSr	vimiSray
sammiSr	sammiSray
pratisammiSr	pratisammiSray
udmudraya	udmudray
parimudraya	parimudray
vimudraya	vimudray
AmuzAya	AmuzAy
pramuzAya	pramuzAy
avamUtraya	avamUtray
pramUtraya	pramUtray
sammUtraya	sammUtray
parimfg	parimfgay
pramfg	pramfgay
vimfg	vimfgay
Amokz	Amokzay
parimokz	parimokzay
pramokz	pramokzay
sampramokz	sampramokzay
pratimokz	pratimokzay
vimokz	vimokzay
sammokz	sammokzay
aBimlE	aBimlA
AmlE	AmlA
parimlE	parimlA
viparimlE	viparimlA
pramlE	pramlA
vimlE	vimlA
upayantr	upayantray
niyantr	niyantray
samyantr	samyantray
anuraYj	anuraj
aparaYj	aparaj
aBiraYj	aBiraj
samaBiraYj	samaBiraj
udraYj	udraj
uparaYj	uparaj
pratiraYj	pratiraj
viraYj	viraj
saMraYj	saMraj
anusaMraYj	anusaMraj
aBisaMraYj	aBisaMraj
virUkz	virUkzay
nirUp	nirUpay
prarUp	prarUpay
virUp	virUpay
atilakz	atilakzay
anulakz	anulakzay
aBilakz	aBilakzay
Alakz	Alakzay
upAlakz	upAlakzay
samAlakz	samAlakzay
upalakz	upalakzay
aByupalakz	aByupalakzay
samupalakz	samupalakzay
sampratilakz	sampratilakzay
vilakz	vilakzay
saMlakz	saMlakzay
viliK	viliKApay
udliNg	udliNgay
anuvf	anuvar
apavf	apavar
apivf	apivar
aBivf	aBivar
Avf	Avar
apAvf	apAvar
upAvf	upAvar
samupAvf	samupAvar
paryAvf	paryAvar
prAvf	prAvar
saMprAvf	saMprAvar
vyAvf	vyAvar
samAvf	samAvar
udvf	udvar
nivf	nivar
upanivf	upanivar
pratinivf	pratinivar
vinivf	vinivar
saMnivf	saMnivar
nisvf	nisvar
parinisvf	parinisvar
parivf	parivar
aBiparivf	aBiparivar
saMparivf	saMparivar
pravf	pravar
prativf	prativar
vivf	vivar
saMvf	saMvar
aBisaMvf	aBisaMvar
samaBisaMvf	samaBisaMvar
parisaMvf	parisaMvar
aDivfj	aDivarj
anuvfj	anuvarj
apavfj	apavarj
vyapavfj	vyapavarj
samapavfj	samapavarj
apivfj	apivarj
aBivfj	aBivarj
avavfj	avavarj
Avfj	Avarj
apAvfj	apAvarj
prAvfj	prAvarj
vyAvfj	vyAvarj
parivyAvfj	parivyAvarj
samAvfj	samAvarj
udvfj	udvarj
nivfj	nivarj
anunivfj	anunivarj
parAvfj	parAvarj
parivfj	parivarj
saMparivfj	saMparivarj
pravfj	pravarj
anupravfj	anupravarj
prativfj	prativarj
vivfj	vivarj
saMvfj	saMvarj
acCavft	acCavart
ativft	ativart
aByativft	aByativart
vyativft	vyativart
samativft	samativart
aDivft	aDivart
anuvft	anuvart
samanuvft	samanuvart
apavft	apavart
vyapavft	vyapavart
samapavft	samapavart
apivft	apivart
aBivft	aBivart
samaBivft	samaBivart
aByavavft	aByavavart
nyavavft	nyavavart
samavavft	samavavart
Avft	Avart
anvatyAvft	anvatyAvart
anvAvft	anvAvart
apAvft	apAvart
aByAvft	aByAvart
udAvft	udAvart
upAvft	upAvart
paryupAvft	paryupAvart
nyAvft	nyAvart
paryAvft	paryAvart
anuparyAvft	anuparyAvart
apaparyAvft	apaparyAvart
aBiparyAvft	aBiparyAvart
upaparyAvft	upaparyAvart
pratiparyAvft	pratiparyAvart
viparyAvft	viparyAvart
prAvft	prAvart
pratyAvft	pratyAvart
vyAvft	vyAvart
samAvft	samAvart
aBisamAvft	aBisamAvart
upasamAvft	upasamAvart
udvft	udvart
samudvft	samudvart
upavft	upavart
samupavft	samupavart
nivft	nivart
anunivft	anunivart
aBinivft	aBinivart
upanivft	upanivart
aByupanivft	aByupanivart
parinivft	parinivart
pratinivft	pratinivart
vinivft	vinivart
samnivft	samnivart
nisvft	nisvart
aBinisvft	aBinisvart
upanisvft	upanisvart
vinisvft	vinisvart
parAvft	parAvart
viparAvft	viparAvart
parivft	parivart
anuparivft	anuparivart
viparivft	viparivart
saMparivft	saMparivart
pravft	pravart
atipravft	atipravart
anupravft	anupravart
aBipravft	aBipravart
upapravft	upapravart
paripravft	paripravart
pratipravft	pratipravart
sampravft	sampravart
aBisampravft	aBisampravart
prativft	prativart
vivft	vivart
ativivft	ativivart
anuvivft	anuvivart
saMvft	saMvart
aDisaMvft	aDisaMvart
aBisaMvft	aBisaMvart
ativfz	ativarz
anuvfz	anuvarz
aBivfz	aBivarz
samaBivfz	samaBivarz
avavfz	avavarz
Avfz	Avarz
udvfz	udvarz
nisvfz	nisvarz
parivfz	parivarz
pravfz	pravarz
aBipravfz	aBipravarz
sampravfz	sampravarz
prativfz	prativarz
vivfz	vivarz
saMvfz	saMvarz
saMvastraya	saMvastray
upavAjaya	upavAjay
nisvap	nisvApay
aDivAs	aDivAsay
anuvAs	anuvAsay
aBivAs	aBivAsay
AvAs	AvAsay
samAvAs	samAvAsay
saMvAs	saMvAsay
saMviGnaya	saMviGnay
praviSAlaya	praviSAlay
anuvIr	anuvIray
AvfzAya	AvfzAy
udvfzAya	udvfzAy
aDivye	aDivyA
apavye	apavyA
apivye	apivyA
aBivye	aBivyA
avavye	avavyA
Avye	AvyA
udvye	udvyA
upavye	upavyA
nivye	nivyA
parivye	parivyA
prativye	prativyA
saMvye	saMvyA
anusaMvye	anusaMvyA
aBisaMvye	aBisaMvyA
upasaMvye	upasaMvyA
nisvraR	nisvraRay
upavrataya	upavratay
viSakalaya	viSakalay
apaSad	apaSat
avaSad	avaSat
vyavaSad	vyavaSat
ASad	ASat
niSad	niSat
parASad	parASat
praSad	praSat
viSad	viSat
saMSad	saMSat
atiSabd	atiSabday
anuSabd	anuSabday
aBiSabd	aBiSabday
pariSabd	pariSabday
viSabd	viSabday
saMSabd	saMSabday
vyatiSF	vyatiSar
anuSF	anuSar
apiSF	apiSar
avaSF	avaSar
ASF	ASar
niSF	niSar
nisSF	nisSar
parASF	parASar
pariSF	pariSar
praSF	praSar
sampraSF	sampraSar
pratiSF	pratiSar
viSF	viSar
aBiviSF	aBiviSar
nirviSF	nirviSar
praviSF	praviSar
saMSF	saMSar
aDiSF	aDiSar
udSF	udSar
saMpariSF	saMpariSar
aBisaMSF	aBisaMSar
atiSaravyaya	atiSaravyay
praSfD	praSarD
atipraSfD	atipraSarD
avaSfD	avaSarD
viSfD	viSarD
avaSE	avaSA
ASE	ASA
niSE	niSA
atiSE	atiSA
nisSE	nisSA
saMSE	saMSA
visaMSE	visaMSA
pariSiTilaya	pariSiTilay
ASrI	ASir
atiSIl	atiSIlay
anuSIl	anuSIlay
pariSIl	pariSIlay
saMSIl	saMSIlay
aBiSyE	aBiSyA
samaBiSyE	samaBiSyA
avaSyE	avaSyA
ASyE	ASyA
praSyE	praSyA
pratiSyE	pratiSyA
saMSyE	saMSyA
aBisaMSyE	aBisaMSyA
avasaMSyE	avasaMSyA
udSraTAya	udSraTAy
viSraTAya	viSraTAy
ASravasya	ASravasy
ASru	ASruz
saMSlakzRaya	saMSlakzRay
upaSlokaya	upaSlokay
saMSlokaya	saMSlokay
udSvi	udSvA
praSvi	praSvA
viSvi	viSvA
saMSvi	saMSvA
niszWIv	niszWu
atisaMDaya	atisaMDay
pratisaMDaya	pratisaMDay
visaparya	visapary
aDisaBAj	aDisaBAjay
acCasf	acCasar
atisf	atisar
anusf	anusar
atyanusf	atyanusar
aByanusf	aByanusar
vyanusf	vyanusar
apasf	apasar
vyapasf	vyapasar
apisf	apisar
aBisf	aBisar
atyaBisf	atyaBisar
avasf	avasar
aByavasf	aByavasar
samavasf	samavasar
Asf	Asar
atyAsf	atyAsar
apAsf	apAsar
pratyAsf	pratyAsar
vyAsf	vyAsar
utsf	utsar
anUtsf	anUtsar
protsf	protsar
pratyutsf	pratyutsar
samutsf	samutsar
upasf	upasar
aByupasf	aByupasar
pratyupasf	pratyupasar
samupasf	samupasar
nisf	nisar
vinisf	vinisar
aBinissf	aBinissar
samaBinissf	samaBinissar
vinissf	vinissar
anuvinissf	anuvinissar
parAsf	parAsar
upaparAsf	upaparAsar
parisf	parisar
prasf	prasar
atiprasf	atiprasar
anuprasf	anuprasar
aBiprasf	aBiprasar
upaprasf	upaprasar
pratiprasf	pratiprasar
viprasf	viprasar
samprasf	samprasar
pratisf	pratisar
vipratisf	vipratisar
visf	visar
anuvisf	anuvisar
pravisf	pravisar
saMsf	saMsar
anusaMsf	anusaMsar
aBisaMsf	aBisaMsar
upasaMsf	upasaMsar
atisfj	atisarj
aByatisfj	aByatisarj
samatisfj	samatisarj
anusfj	anusarj
aByanusfj	aByanusarj
apasfj	apasarj
vyapasfj	vyapasarj
apisfj	apisarj
pratyapisfj	pratyapisarj
aBisfj	aBisarj
avasfj	avasarj
atyavasfj	atyavasarj
anvavasfj	anvavasarj
aByavasfj	aByavasarj
upAvasfj	upAvasarj
nyavasfj	nyavasarj
pratyavasfj	pratyavasarj
vyavasfj	vyavasarj
samavasfj	samavasarj
Asfj	Asarj
aDyAsfj	aDyAsarj
upAsfj	upAsarj
samAsfj	samAsarj
utsfj	utsarj
anUtsfj	anUtsarj
aByutsfj	aByutsarj
paryutsfj	paryutsarj
vyutsfj	vyutsarj
samutsfj	samutsarj
upasfj	upasarj
nirupasfj	nirupasarj
samupasfj	samupasarj
nisfj	nisarj
pratinisfj	pratinisarj
saMnisfj	saMnisarj
nissfj	nissarj
aBinissfj	aBinissarj
pratinissfj	pratinissarj
parAsfj	parAsarj
parisfj	parisarj
prasfj	prasarj
anuprasfj	anuprasarj
pariprasfj	pariprasarj
pratiprasfj	pratiprasarj
visfj	visarj
anuvisfj	anuvisarj
aBivisfj	aBivisarj
udvisfj	udvisarj
prativisfj	prativisarj
saMvisfj	saMvisarj
saMsfj	saMsarj
anusaMsfj	anusaMsarj
upasaMsfj	upasaMsarj
parisaMsfj	parisaMsarj
pratisaMsfj	pratisaMsarj
atisfp	atisarp
vyatisfp	vyatisarp
aDisfp	aDisarp
samaDisfp	samaDisarp
anusfp	anusarp
samanusfp	samanusarp
apasfp	apasarp
pratyapasfp	pratyapasarp
vyapasfp	vyapasarp
aBisfp	aBisarp
avasfp	avasarp
anvavasfp	anvavasarp
upAvasfp	upAvasarp
paryavasfp	paryavasarp
pratyavasfp	pratyavasarp
vyavasfp	vyavasarp
Asfp	Asarp
udAsfp	udAsarp
upodAsfp	upodAsarp
samAsfp	samAsarp
utsfp	utsarp
protsfp	protsarp
samutsfp	samutsarp
upasfp	upasarp
samupasfp	samupasarp
vinisfp	vinisarp
nissfp	nissarp
aBinissfp	aBinissarp
vinissfp	vinissarp
parisfp	parisarp
prasfp	prasarp
anuprasfp	anuprasarp
aBiprasfp	aBiprasarp
pratiprasfp	pratiprasarp
viprasfp	viprasarp
samprasfp	samprasarp
visfp	visarp
anuvisfp	anuvisarp
saMsfp	saMsarp
anusaMsfp	anusaMsarp
upasaMsfp	upasaMsarp
visaMsfp	visaMsarp
aBiso	aBisA
avaso	avasA
aDyavaso	aDyavasA
anvavaso	anvavasA
udavaso	udavasA
aByudavaso	aByudavasA
upAvaso	upAvasA
niravaso	niravasA
prAvaso	prAvasA
pratyavaso	pratyavasA
vyavaso	vyavasA
anuvyavaso	anuvyavasA
saMvyavaso	saMvyavasA
samavaso	samavasA
niso	nisA
pariRiso	pariRisA
praRiso	praRisA
pariso	parisA
praso	prasA
viso	visA
saMso	saMsA
aBisAntv	aBisAntvay
aBisUc	aBisUcay
AsUtr	AsUtray
samAsUtr	samAsUtray
visUtr	visUtray
atiskand	atiskad
aDiskand	aDiskad
anuskand	anuskad
aBiskand	aBiskad
pratyaBiskand	pratyaBiskad
avaskand	avaskad
aByavaskand	aByavaskad
paryavaskand	paryavaskad
pratyavaskand	pratyavaskad
samavaskand	samavaskad
Askand	Askad
samAskand	samAskad
utskand	utskad
upaskand	upaskad
pariskand	pariskad
praskand	praskad
aBipraskand	aBipraskad
viskand	viskad
saMskand	saMskad
aBiskaB	aBiskaBAy
viskaB	viskaBAy
viskumB	viskuB
upastaB	upastaBAy
vizwaB	vizwaBAy
anustf	anustar
aBizwf	aBizwar
avastf	avastar
samavastf	samavastar
Astf	Astar
upAstf	upAstar
prAstf	prAstar
pratyAstf	pratyAstar
samAstf	samAstar
upastf	upastar
nizwf	nizwar
nisstf	nisstar
parizwf	parizwar
prastf	prastar
anuprastf	anuprastar
aBiprastf	aBiprastar
upaprastf	upaprastar
vizwf	vizwar
ativizwf	ativizwar
anuvizwf	anuvizwar
avizwf	avizwar
pravizwf	pravizwar
saMstf	saMstar
aBisaMstf	aBisaMstar
parisaMstf	parisaMstar
nizwyE	nizwyA
prastyE	prastyA
saMstyE	saMstyA
apaspf	apaspar
avaspf	avaspar
Aspf	Aspar
nisspf	nisspar
vispf	vispar
aDispfS	aDisparS
anuspfS	anusparS
apaspfS	apasparS
aBispfS	aBisparS
AspfS	AsparS
utspfS	utsparS
upaspfS	upasparS
pratyupaspfS	pratyupasparS
samupaspfS	samupasparS
nispfS	nisparS
parispfS	parisparS
saMspfS	saMsparS
anusaMspfS	anusaMsparS
aBisaMspfS	aBisaMsparS
parisaMspfS	parisaMsparS
praspfD	praspUrD
saMspfh	saMspfhay
anusmf	anusmar
pratyanusmf	pratyanusmar
samanusmf	samanusmar
apasmf	apasmar
upasmf	upasmar
nismf	nismar
vinismf	vinismar
prasmf	prasmar
pratismf	pratismar
vismf	vismar
saMsmf	saMsmar
anusaMsmf	anusaMsmar
aBisaMsmf	aBisaMsmar
acCasyand	acCasyad
atisyand	atisyad
anusyand	anusyad
aBisyand	aBisyad
samaBisyand	samaBisyad
avasyand	avasyad
aByavasyand	aByavasyad
Asyand	Asyad
upAsyand	upAsyad
upasyand	upasyad
nisyand	nisyad
aBinisyand	aBinisyad
nissyand	nissyad
parisyand	parisyad
prasyand	prasyad
pariprasyand	pariprasyad
visyand	visyad
anuvisyand	anuvisyad
aBivisyand	aBivisyad
saMsyand	saMsyad
anusaMsyand	anusaMsyad
prasrE	prasrA
atisvf	atisvar
anusvf	anusvar
samanusvf	samanusvar
aBisvf	aBisvar
avasvf	avasvar
upasvf	upasvar
nisvf	nisvar
nissvf	nissvar
parisvf	parisvar
prasvf	prasvar
pratisvf	pratisvar
saMsvf	saMsvar
aBisaMsvf	aBisaMsvar
pratyAsvf	pratyAsvar
atihf	atihar
aByatihf	aByatihar
pratyatihf	pratyatihar
vyatihf	vyatihar
aDihf	aDihar
anuhf	anuhar
vyapahf	vyapahar
aBihf	aBihar
pratyaBihf	pratyaBihar
avahf	avahar
anvavahf	anvavahar
aByavahf	aByavahar
upAvahf	upAvahar
aByupAvahf	aByupAvahar
pratyavahf	pratyavahar
vyavahf	vyavahar
saMvyavahf	saMvyavahar
samavahf	samavahar
Ahf	Ahar
atyAhf	atyAhar
aDyAhf	aDyAhar
anvAhf	anvAhar
samanvAhf	samanvAhar
apyAhf	apyAhar
aByAhf	aByAhar
udAhf	udAhar
anUdAhf	anUdAhar
aByudAhf	aByudAhar
upodAhf	upodAhar
pratyudAhf	pratyudAhar
samudAhf	samudAhar
upAhf	upAhar
aByupAhf	aByupAhar
pratyupAhf	pratyupAhar
samupAhf	samupAhar
upanyAhf	upanyAhar
paryAhf	paryAhar
pratiparyAhf	pratiparyAhar
pratyAhf	pratyAhar
vyAhf	vyAhar
ativyAhf	ativyAhar
anuvyAhf	anuvyAhar
apavyAhf	apavyAhar
aBivyAhf	aBivyAhar
samaBivyAhf	samaBivyAhar
anusamaBivyAhf	anusamaBivyAhar
pravyAhf	pravyAhar
samAhf	samAhar
anusamAhf	anusamAhar
aBisamAhf	aBisamAhar
upasamAhf	upasamAhar
udhf	udhar
aDyudhf	aDyudhar
anUdhf	anUdhar
apodhf	apodhar
aByudhf	aByudhar
samaByudhf	samaByudhar
upodhf	upodhar
prodhf	prodhar
pratyudhf	pratyudhar
vyudhf	vyudhar
samudhf	samudhar
upahf	upahar
aByupahf	aByupahar
pratyupahf	pratyupahar
samupahf	samupahar
nihf	nihar
aBinihf	aBinihar
nirhf	nirhar
aBinirhf	aBinirhar
upanirhf	upanirhar
vinirhf	vinirhar
parAhf	parAhar
pratiparAhf	pratiparAhar
parihf	parihar
anuparihf	anuparihar
aBiparihf	aBiparihar
viparihf	viparihar
saMparihf	saMparihar
prahf	prahar
anuprahf	anuprahar
aBiprahf	aBiprahar
pratiprahf	pratiprahar
samprahf	samprahar
pratihf	pratihar
vihf	vihar
aBivihf	aBivihar
parivihf	parivihar
sampravihf	sampravihar
saMvihf	saMvihar
anusamhf	anusamhar
aBisamhf	aBisamhar
upasamhf	upasamhar
samupasamhf	samupasamhar
pratisamhf	pratisamhar
anuhfz	anuharz
aBihfz	aBiharz
samaBihfz	samaBiharz
avahfz	avaharz
Ahfz	Aharz
vyAhfz	vyAharz
udhfz	udharz
prodhfz	prodharz
samudhfz	samudharz
nihfz	niharz
parihfz	pariharz
prahfz	praharz
samprahfz	sampraharz
pratihfz	pratiharz
vihfz	viharz
samhfz	samharz
parisamhfz	parisamharz
pratisamhfz	pratisamharz
avahil	avahel
vihil	vihel
aBihvf	aBihvar
avahvf	avahvar
Ahvf	Ahvar
upahvf	upahvar
samupahvf	samupahvar
parihvf	parihvar
prahvf	prahvar
pratihvf	pratihvar
vihvf	vihvar
samhvf	samhvar
atihve	atihvA
anuhve	anuhvA
aBihve	aBihvA
prABihve	prABihvA
avahve	avahvA
Ahve	AhvA
atyAhve	atyAhvA
anvAhve	anvAhvA
aByAhve	aByAhvA
upAhve	upAhvA
paryAhve	paryAhvA
pratyAhve	pratyAhvA
vyAhve	vyAhvA
samAhve	samAhvA
udhve	udhvA
upahve	upahvA
paryupahve	paryupahvA
pratyupahve	pratyupahvA
samupahve	samupahvA
nihve	nihvA
nirhve	nirhvA
parihve	parihvA
prahve	prahvA
pratiprahve	pratiprahvA
pratihve	pratihvA
vihve	vihvA
samhve	samhvA
